hote	hot
tsogo	tsv
jakun	jak
kasua	khs
godie	god
hawaiian	haw
san martin quechua	qvs
ejamat	eja
lavrung	jiq
bamukumbit	bqt
old frisian	ofs
simeku	smz
mundu	muh
amganad ifugao	ifa
karawa	xrw
lushootseed	lut
san pedro quiatoni zapotec	zpf
standard french	fra
nhirrpi	hrp
southern ohlone	css
iloko	ilo
timucua	tjm
kankanay	xnn
kangean	kkv
khunsari	kfm
gaam	tbi
classical tibetan	xct
kurama	krh
bhili	bhb
gola	gol
southern altai	alt
larantuka malay	lrt
atohwaim	aqm
duriankere	dbn
korubo	xor
pisabo	pig
paipai	ppi
western maninkakan	mlq
duna	duc
laimbue	lmx
khoekhoe	naq
warrwa	wwr
nila	nil
central mashan miao	hmm
warrgamay	wgy
ngom	nra
kharia thar	ksy
northwestern ojibwa	ojb
ron	cla
sajau basap	sjb
san miguel el grande mixtec	mig
northern ohlone	cst
nupe-nupe-tako	nup
walmajarri	wmt
kayan river kayan	xkn
mittu	mwu
khang	kjm
ngoreme	ngq
poqomam	poc
teluti	tlt
italian	ita
tirahi	tra
muong	mtq
zangskari	zau
corsican	cos
ikizu	ikz
karanga	kth
dubli	dub
hozo	hoz
konyak naga	nbe
hmong do	hmv
batak toba	bbc
busuu	bju
kaiwa	kgk
huastec	hus
asheninka pajonal	cjo
eastern lalu	yit
eastern gorkha tamang	tge
kabwari	kcw
temi	soz
kuuku-ya'u	kuy
emumu	enr
tobanga	tng
cemuhi	cam
lawu	lwu
fungwa	ula
amdo tibetan	adx
tiefo	tiq
sanaani arabic	ayn
ozolotepec zapotec	zao
fala	fax
paafang	pfa
llengua de signes catalana	csc
middle cornish	crx
maung	mph
ikpeng	txi
mbudum	xmd
ngwe	nwe
uare	ksj
eastern krahn	kqo
moingi	mwz
tlhingan-hol	tlh
micmac	mic
siwi	siz
fulnio	fun
nali	nss
cherepon	cpn
iatmul	ian
gweno	gwe
semandang	sdm
andegerebinha	adg
grebo	gec
macanese	mzs
reunion creole french	rcf
hlai	lic
afghan sign language	afg
baga sobane	bsv
sranan	srn
chantyal	chx
aguaruna	agr
ajyininka apurucayali	cpc
konkomba	xon
kanggape	igm
selepet	spl
omaha-ponca	oma
kumbaran	wkb
baruya	byr
ovdalian	ovd
nguluwan	nuw
kaansa	gna
nadruvian	ndf
nyindrou	lid
mambwe-lungu	mgr
dominican sign language	doq
elamite	elx
margi	mrt
miluk	iml
meskwaki	sac
northern sorsoganon	bks
lari	lrl
o'du	tyh
thulung	tdh
lindu	klw
uru-pa-in	urp
anong	nun
naasioi	nas
ukpet-ehom	akd
ambo-pasco quechua	qva
somba-siawari	bmu
lambichhong	lmh
lule	ule
kashubian	csb
turung	try
ido	ido
zhire	zhi
saliba	sbe
tiv	tiv
ashaninka	cni
nimboran	nir
dirim	dir
rogo	rod
kanan	zkn
khisa	kqm
canar highland quichua	qxr
nabay	kxi
hungarian sign language	hsh
guila zapotec	ztu
mokpwe	bri
wangkayutyuru	wky
ake	aik
khamti	kht
mongolian sign language	msr
madak	mmx
rer bare	rer
murrinypata	mwf
wumboko	bqm
babanki	bbk
tilung	tij
tiale	mnl
nigerian fulfulde	fuv
puyo	xpy
athpariya	aph
quebec french	fra
ngabere	gym
wojenaka	jod
busoa	bup
porohanon	prh
ijo	ijc
waneci	wne
hellenistic greek	grc
lovono	vnk
fanagalo	fng
ulster	gle
saxwe gbe	sxw
hijuk	hij
byangsi	bee
gera	gew
solos	sol
gimnime	gmn
wu chinese	wuu
degema	deg
wunumara	wnn
machinga	mvw
south central banda	lnl
lombard	lmo
guajajara	gub
maori	mri
nyungwe	nyu
votic	vot
teke-ebo	ebo
galice	gce
lepki	lpe
chavacano	cbk
chinali	cih
bay miwok	mkq
aguacateco	agu
lou	loj
swabian	swg
low german	nds
skou	skv
eastern highland otomi	otm
faroese	fao
badjiri	jbi
kaxarari	ktx
mazaltepec zapotec	zpy
sibe	nco
tsonga	tso
togoyo	tgy
yombe	yom
biao mon	bmt
bangba	bbe
keder	kdy
githabul	gih
hertevin	hrt
pangutaran sama	slm
jicarilla apache	apj
tchitchege	tck
aringa	luc
barasana-eduria	bsn
kaapor sign language	uks
sewa bay	sew
tamil	tam
jere	jer
mandinka	mnk
vwanji	wbi
tachoni	lts
bibbulman	xbp
burmese	mya
pyapun	pcw
baga manduri	bmd
bolia	bli
malinaltepec me'phaa	tcf
finongan	fag
kaningi	kzo
upper chehalis	cjh
tariana	tae
klamath-modoc	kla
mbugu	mhd
konjo	kjc
western krahn	krw
asaro'o	mtv
malas	mkr
warkay-bipim	bgv
northern bobo madare	bbo
lokaa	yaz
akum	aku
yameo	yme
zinza	zin
sialum	slw
wotapuri-katarqalai	wsv
west yugur	ybe
monde	mnd
archi	aqc
nyemba	nba
arritinngithigh	rrt
mapoyo	mcg
yinhawangka	ywg
ayizi	yyz
hanga	hag
antakarinya	ant
highland konjo	kjk
lenyima	ldg
dema	dmx
itza	itz
jemez	tow
paraguayan guarani	gug
pemon	aoc
kanjari	kft
tibea	ngy
dene suline	chp
mpumpong	mgg
temoaya otomi	ott
bo-ung	mux
tz'utujil	tzj
marka	rkm
bakhtiari	bqi
chulym	clw
chukchee	ckt
tuvinian	tyv
juang	jun
barakai	baj
nshi	nsc
central mnong	cmo
lendu	led
xiriana	xir
tepo krumen	ted
koyraboro senni songhay	ses
kumbewaha	xks
brooke's point palawano	plw
kinaray-a	krj
old slavonic	chu
lonzo	lnz
parsi-dari	prd
eastern huishui miao	hme
amri karbi	ajz
kinyarwanda	kin
monumbo	mxk
zo'e	pto
mocho	mhc
bonerif	bnv
sha	scw
belanda bor	bxb
laru	lan
sened	sds
mudhili gadaba	gau
takelma	tkm
korean	kor
chewong	cwg
uvean	uve
baras	brs
banggarla	bjb
yakut	sah
kulon-pazeh	uun
kaulong	pss
abom	aob
ventureno	veo
small flowery miao	sfm
pauri bareli	bfb
worimi	kda
middle high german	gmh
haveke	hvk
russian	rus
bentong	bnu
wemba wemba	xww
ibibio	ibb
acroa	acs
green gelao	giq
tidikelt tamazight	tia
taita	dav
border kuna	kvn
ibani	iby
wawa	www
kisan	xis
maaka	mew
ija-zuba	vki
hano	lml
buso	bso
glio-oubi	oub
vanimo	vam
ninia yali	nlk
mayangna	yan
masimasi	ism
cerma	cme
ehueun	ehu
latvian	lav
khao	xao
anakalangu	akg
bepour	bie
mewati	wtm
jacaltec	jac
central okinawan	ryu
kathu	ykt
north arabian	xna
maninka	emk
kisongo maasai	mas
mag-indi ayta	blx
fam	fam
yokuts	yok
southern sorsoganon	srv
gitua	ggt
el alto zapotec	zpp
aneme wake	aby
hupde	jup
ixcatec	ixc
sheng	swh
kuikuro-kalapalo	kui
miriwoong sign language	rsm
maring naga	nng
kam	kdx
lewo	lww
ilue	ilv
anam	pda
anasi	bpo
mazagway	dkx
waru	wru
kwama	kmq
bon gula	glc
kensiu	kns
faiwol	fai
wawonii	wow
luvale	lue
kotafon gbe	kqk
koromfe	kfz
ukue	uku
alutor	alr
french	fra
siuslaw	sis
nyam	nmi
chuukese	chk
lonwolwol	crc
koroni	xkq
salvadoran sign language	esn
taje	pee
zoogocho zapotec	zpq
san luis temalacayuca popoloca	pps
tobilung	tgb
sarikoli	srh
dongxiang	sce
vaiphei	vap
oirata	oia
namia	nnm
lelepa	lpa
piro	pib
bakwe	bjw
col	liw
chukwa	cuw
wadi wadi	xwd
kerak	hhr
chipaya	cap
phom naga	nph
amal	aad
wasa	wss
yis	yis
gilima	gix
mandarin chinese	cmn
cauca	cca
wardandi	wxw
central bai	bca
sajalong	sjl
suma	sqm
pye krumen	pye
alugu	aub
alsatian	gsw
kayaw	kvl
wampar	lbq
inuit sign language	iks
yareba	yrb
itik	itx
yagara	yxg
bidiyo	bid
sakirabia	skf
whitesands	tnp
tabo	knv
tohono o'odham	ood
dewoin	dee
southern qiandong miao	hms
kaningra	knr
zaramo	zaj
lengua de senas panamenas	lsp
tulishi	tey
salinan	sln
southwest gbaya	gso
dakpakha	dka
ncane	ncr
pohnpeian	pon
lengilu	lgi
moikodi	mkp
//xegwi	xeg
kakwa	keo
mvanip	mcj
besisi	mhe
numanggang	nop
tsimshian	tsi
pu-xian chinese	cpx
bribri	bzd
biritai	bqq
urartian	xur
ngadjunmaya	nju
haroi	hro
lauan	llx
fuyug	fuy
papel	pbo
mocheno	mhn
central nicobarese	ncb
osing	osi
lodhi	lbm
djingili	jig
southern conchucos ancash quechua	qxo
lahu	lhu
itu mbon uzo	itm
tabla	tnm
nzanyi	nja
stod bhoti	sbu
phuan	phu
ap ma	kbx
kunda	kdn
tidaa mixtec	mtx
taroko	trv
mogofin	mfg
jamiltepec mixtec	mxt
lipan apache	apl
tsou	tsu
piscataway	psy
bamwe	bmg
finland-swedish sign language	fss
veluws	vel
balo	bqo
eastern pomo	peb
godwari	gdx
gheg albanian	aln
wiru	wiu
kuamasi	yku
yaoure	yre
ede cabe	cbj
south azerbaijani	azb
slovak	slk
tela-masbuar	tvm
japanese sign language	jsl
liv	liv
yukaghir	yux
duvle	duv
tachelhit	shi
muratayak	asx
sarangani blaan	bps
tawr chin	tcp
lakhota	lkt
tukpa	tpq
batsbi	bbl
bactrian	xbc
tai pao	tpo
minangkabau	min
mahou	mxx
nabi	mty
dibabawon manobo	mbd
puroik	suv
uri	uvh
sori-harengan	sbh
volscian	xvo
anyin	any
magori	zgr
awun	aww
sierra de juarez zapotec	zaa
northern one	onr
chaga	jmc
dan	dnj
obo manobo	obo
zan gula	zna
mbangala	mxg
angal	age
bolyu	ply
phupha	yph
kiorr	xko
pali	pli
egypt sign language	esl
mutu	tuc
bangandu	bgf
duau	dva
piamatsina	ptr
wymysorys	wym
serbo-croatian	hrv
jewish babylonian aramaic	tmr
maklew	mgf
tondi songway kiini	tst
rajbanshi	rjs
gowro	gwf
kamula	xla
ndai	gke
menominee	mez
tokharian b	txb
vao	vao
mengaka	xmg
limbum	lmp
pathiya	pty
alacatlatzala mixtec	mim
wolaitta	wal
kantosi	xkt
kir-balar	kkr
bhadrawahi	bhd
minaean	inm
itene	ite
con	cno
betawi	bew
aweer	bob
afro-seminole creole	afs
dolpo	dre
zangwal	zah
southern mnong	mnn
nafi	srf
gurmana	gvm
church slavonic	chu
cavinena	cav
uda	uda
sangkong	sgk
kikuyu	kik
sowari	dmy
southern nicobarese	nik
sambalpuri	spv
mangga buang	mmo
mese	mci
ife	ife
chenapian	cjn
desiya	dso
barababaraba	rbp
romanian sign language	rms
old kentish sign language	okl
southern carrier	caf
bengali	ben
tumari kanuri	krt
ashtiani	atn
kriol english	bzj
rutul	rut
rennell-bellona	mnv
krim	krm
tigon mbembe	nza
lower sorbian	dsb
old breton	obt
malecite-passamaquoddy	pqm
margu	mhg
skolt sami	sms
araona	aro
longto	wok
manam	mva
alune	alp
alo phola	ypo
siwu	akp
judeo-tripolitanian arabic	yud
kodaku	ksz
flaaitaal	fly
lanima	lnw
bole	bol
uzbeki arabic	auz
kibiri	prm
naukan yupik	ynk
wakawaka	wkw
panoan katukina	knt
pattani	lae
atikamekw	atj
nyiyaparli	nad
camsa	kbh
mandar	mdr
isarog agta	agk
marma	rmz
saafi-saafi	sav
malila	mgq
seimat	ssg
embera	emp
digo	dig
sikaritai	tty
bumang	bvp
sabu	hvn
judeo-moroccan arabic	aju
cherokee	chr
northern conchucos ancash quechua	qxn
bakoko	bkh
maiadomu	mzz
ugandan sign language	ugn
powari	pwr
adioukrou	adj
ronji	roe
anamgura	imi
kuo	xuo
ghodoberi	gdo
callawalla	caw
andio	bzb
mbati	mdn
nanai	gld
momina	mmb
arandai	jbj
nawaru	nwr
cahuilla	chl
wares	wai
hema	nix
nama	naq
chol	ctu
central siberian yupik	ess
monsang naga	nmh
tawala	tbo
tigak	tgc
yirandali	ljw
tii	txq
shanenawa	swo
kekchi	kek
yeyi	yey
dutton world speedwords	dws
amahuaca	amc
kuvi	kxv
paiwan	pwn
rundi	run
sou nama	tlt
khana	ogo
gulf arabic	afb
lashi	lsi
pijin	pis
pintiini	pti
munda	unx
north alaskan inupiatun	esi
guyanese creole english	gyn
el hugeirat	elh
tebi	dmu
u	uuu
kuy	kdt
gudu	gdu
western meohang	raf
paiute	pao
candoshi-shapra	cbu
tumshuqese	xtq
kwakiutl	kwk
chambri	can
santa lucia monteverde mixtec	mdv
mape	mlh
nganyaywana	nyx
kiunum	wei
sara kaba	sbz
tregami	trm
wajuk	xwj
oroha	ora
kohistani shina	plk
geko karen	ghk
ihievbe	ihi
garig-ilgar	ilg
trinidad and tobago sign language	lst
humburi senni songhay	hmb
levuka	lvu
nanti	cox
southern muji	ymc
balkan gagauz turkish	bgx
kimaama	kig
kimaragang	kqr
yi	iii
wabo	wbb
kadaru	kdu
segai	sge
anindilyakwa	aoi
santa ines yatzechi zapotec	zpn
keningau murut	kxi
yamdena	jmd
pinigura	pnv
etebi	etb
central malay	pse
bukat	bvk
western niger fulfulde	fuh
rapanui	rap
arvanitika albanian	aat
eastern ngad'a	nea
alsea	aes
eastern qiandong miao	hmq
hanga hundi	wos
jowulu	jow
ir	irr
djambarrpuyngu	djr
bima	bhp
squliq	tay
makhuwa	vmw
gongduk	goe
bahau	bhv
kogi	kog
yaur	jau
jeri kuo	jek
uvbie	evh
gugu warra	wrw
man met	mml
east masela	vme
sakan	kho
sakalava malagasy	skg
santa teresa cora	cok
sulod	srg
southern sierra miwok	skd
molale	mbe
oko-eni-osayen	oks
wasu	wsu
iresim	ire
lasi	lss
nyulnyul	nyv
zeme naga	nzm
patamona	pbc
papantla totonac	top
western ojibwa	ojw
vanuma	vau
yauyos quechua	qux
miskito	miq
tshangla	tsj
portuguese	por
west uvean	uve
lele	lln
bisa	bib
cafundo creole	ccd
nemi	nem
kao	kax
mednyj aleut	mud
hawai'i creole english	hwc
nefamese	nef
adhola	adh
awngthim	gwm
michoacan mazahua	mmc
old uighur	???
eastern kayah	eky
zigula	ziw
estonian sign language	eso
yogad	yog
mapos buang	bzh
para arara	aap
kofa	kso
salar	slr
karo	arr
naluo yi	ylo
chigmecatitlan mixtec	mii
eastern highland chatino	cly
jejueo	jje
iguta	nar
manem	jet
butmas-tur	bnr
eastern huasteca nahuatl	nhe
plains cree	crk
mbe	mfo
nyangga	nny
chicomuceltec	cob
moloko	mlw
ahanta	aha
mauwake	mhl
apma	app
kinalakna	kco
baruga	bjz
matses	mcf
lokoya	lky
lehar	cae
lumbu	lup
wangaaybuwan-ngiyambaa	wyb
old church slavonic	chu
ganang	gne
bhil	sbn
wangganguru	wgg
yeretuar	gop
deutsch	deu
amol	alx
moskona	mtj
arikara	ari
north babar	bcd
abinomn	bsa
north bolivian quechua	qul
rapting	rpt
koneraw	kdw
thangal naga	nki
wetamut	wwo
southeastern nochixtlan mixtec	mxy
afade	aal
olu'bo	lul
kisankasa	kqh
we southern	gxx
mofu-gudur	mif
sherdukpen	sdp
northern ghale	ghh
judeo-tat	jdt
venezuelan sign language	vsl
yami	tao
mashco piro	cuj
reyesano	rey
tangut	txg
nyaw	nyw
surbakhal	sbj
liana-seti	ste
lyele	lee
dibole	bvx
manduri	bmd
aranama-tamique	xrt
songe	sop
japreria	jru
ambo	amb
chong	cog
ecuadorian sign language	ecs
itelmen	itl
stellingwerfs	stl
asas	asd
ghanaian sign language	gse
lavatbura-lamusong	lbv
northern uzbek	uzn
isirawa	srl
wogeo	woc
masiwang	bnf
highland popoluca	poi
ughele	uge
andalusian arabic	xaa
nagarchal	nbg
ainu	ain
unde kaili	unz
yawijibaya	jbw
thachanadan	thn
mt. iraya agta	atl
gurinji	gue
jumli	jml
kalo finnish romani	rmf
urak lawoi'	urk
baldemu	bdn
kachin	kac
southern tujia	tjs
bieria	brj
kerek	krk
daka	ccg
ende	end
nayini	nyq
teke-fuumu	ifm
hmong daw	mww
musi	mui
yemba	ybb
bogaya	boq
michoacan nahuatl	ncl
saep	spd
kuvale	olu
niuatoputapu	nkp
nakai	nkj
yinwum	yxm
iban	iba
classical nahuatl	nci
pima	ood
lubuagan kalinga	knb
dyan	dya
xaracuu	ane
malgbe	mxf
kumam	kdi
makayam	aup
ternate	tft
ga	gaa
omagua	omg
minigir	bxf
yanda	yda
dusun witu	duw
orizaba nahuatl	nlv
yangben	yav
yauma	yax
lao	lao
haji	hji
assyrian neo-aramaic	aii
umpila	ump
awera	awr
yemsa	jnj
caluyanun	clu
large flowery miao	hmd
paliyan	pcf
eastern acipa	acp
sumau	six
hre	hre
mmaala	mmu
zokhuo	yzk
cuyonon	cyo
kaduo	ktp
waamwang	wmn
kundal shahi	shd
anuta	aud
hobyot	hoh
saluan	loe
osatu	ost
ankave	aak
bera	brf
panara	kre
batak	bya
classical mongolian	cmg
ikalanga	kck
mudu koraga	vmd
ilianen manobo	mbi
tabaa zapotec	zat
dangaleat	daa
puquina	puq
mbay	myb
i-wak	iwk
gebe	gei
awjilah	auj
alor	aol
chorti	caa
koyo	koh
kara-kalpak	kaa
haroti	hoj
juquila mixe	mxq
ndendeule	dne
gadjerawang	gdh
nauo	nwo
wayana	way
villa viciosa agta	dyg
gujari	gju
eastern bru	bru
samberigi	ssx
birri	bvq
north ndebele	nde
wancho naga	nnp
pa di	pdi
surui do para	mdz
koiali	kpx
moo	gwg
kukele	kez
neve'ei	vnm
bhatri	bgw
samburu	saq
kpala	kpl
panytyima	pnw
markweeta	enb
papar	dpp
andh	anr
notre	bly
bago-kusuntu	bqg
avatime	avn
waci gbe	wci
wakona	waf
arhuaco	arh
ikaranggal	ikr
budibud	btp
dar sila daju	dau
babungo	bav
saba	saa
northern betsimisaraka malagasy	bmm
hangaza	han
turoyo	tru
kesawai	xes
yele	yle
san agustin mixtepec zapotec	ztm
highland puebla nahuatl	azz
burarra	bvr
majhwar	mmj
bugan	bbh
pahlavani	phv
efik	efi
stoney	sto
batu	btu
guianese creole french	gcr
bebele	beb
tetum	tet
mamanwa	mmn
tasawaq	twq
idoma	idu
luchazi	lch
manipuri	mni
mbato	gwa
laven	lbo
kaiep	kbw
ahwai	nfd
nyore	nyd
auwe	smf
southern haida	hax
bacanese malay	btj
n'ko	nqo
makurap	mpu
cocos islands malay	coa
bangubangu	bnx
romano-greek	rge
deccan	dcc
wanka qechua	qvw
gozarkhani	goz
mozambican sign language	mzy
keyagana	kyg
northeast kiwai	kiw
lahnda	lah
mal	mlf
bulgarian sign language	bqn
bagheli	bfy
momuna	mqf
dibiyaso	dby
jiru	jrr
golin	gvf
shendu	shl
khamba	kbg
glaro-twabo	glr
hakka chinese	hak
karey	kyd
muda	ymd
kitan	zkt
kgalagadi	xkv
lawangan	lbx
chincha quechua	qxc
shehri	shv
teke	tek
talu	yta
kasem	xsm
ngurmbur	nrx
gaa	ttb
bulgarian	bul
dineor	mrx
old mon	omx
bodo parja	bdv
mfumte	nfu
western canadian inuktitut	ikt
alawa	alh
larteh	lar
kupsabiny	kpz
miyobe	soy
australian aborigines sign language	asw
dargwa	dar
english	eng
guanche	gnc
pennsylvania german	pdc
mboko	mdu
eastern durango nahuatl	azd
guarequena	gae
quechan	quz
latvian romani	rml
manta	myg
soga	xog
kodi	kod
lenje	leh
busang kayan	bfg
ogbia	ogb
duya	ldb
tulu-bohuai	rak
suya	suy
chinese	cmn
tat	ttt
lehalurup	urr
wintu	wit
urat	urt
ila	ilb
silimo	wul
igede	ige
quechua cusco	quz
german	deu
bai	bfc
tefaro	tfo
turkmen	tuk
beti	eot
ajie	aji
chinsenga	nse
jiiddu	jii
ganggalida	gcd
mahican	mjy
wikngenchera	wua
klias river kadazan	kqt
san pedro amuzgos amuzgo	azg
yerong	yrn
andajin	ajn
gbari	gby
hiberno-scottish gaelic	ghc
punan merah	puf
edomite	xdm
waube	kop
tsoa	hio
tatana	txx
chamalal	cji
southeastern tarahumara	tcu
rongpo	rnp
marti ke	zmg
aekyom	awi
teribe	tfr
dano	aso
yaleba	ylb
north giziga	gis
sam	snx
san miguel piedras mixtec	xtp
ojibwe	otw
ndonde hamba	njd
hoia hoia	hhi
north azerbaijani	azj
minica huitoto	hto
tiwa	tix
guarani	gug
haiphong sign language	haf
jehai	jhi
sochiapan chinantec	cso
phoenician	phn
hausa	hau
besme	bes
kimbundu	kmb
mazatlan mixe	mzl
sarua	swy
pari	lkr
kaki ae	tbd
bilua	blb
san juan teita mixtec	xtj
phrae pwo karen	kjt
pamona	pmf
southern bai	bfs
thayore	thd
dela-oenale	row
dumagat	agv
okiek	oki
enggano	eno
kungkari	lku
binumarien	bjr
honi	how
lojban	jbo
adele	ade
nhuwala	nhf
mantsi	nty
nyankpa	yes
kumiai	dih
bamun	bax
wik-iiyanh	wij
alviri-vidari	avd
kiswahili	swh
ombamba	mbm
gaina	gcn
dungra bhil	duh
woiwurrung	wyi
chabu	sbf
kamasa	klp
kwaja	kdz
sou upaa	wha
north mofu	mfk
kamayura	kay
tami	tmy
rikbaktsa	rkb
mapia	mpy
tula	tul
somray	smu
lusitanian	xls
divehi	div
haruku	hrk
masalit	mls
palaka senoufo	plr
hamba	hba
gants	gao
southern kiwai	kjd
ignaciano	ign
bilakura	bql
wuzlam	udl
asmat	cns
kuku-ugbanh	ugb
taliabu	tlv
tese	keg
phong-kniang	pnx
davawenyo	daw
soli	sby
pahanan agta	apf
naxi	nxq
bamali	bbq
dimbong	dii
chaha	sgw
lasgerdi	lsa
kapin	tbx
tyaraity	woa
traveller scottish	trl
keijar	kdy
kombio	xbi
keiyo	eyo
nahuatl	nhe
northern qiandong miao	hea
aari	aiz
kurdish	kmr
enrekang	ptt
minkin	xxm
north moluccan malay	max
tooro	ttj
kei	kei
kru'ng 2	krr
weliki	klh
ngizim	ngi
china buriat	bxu
pudtol atta	atp
sumtu chin	csv
kenswei nsei	ndb
soo	teu
yoron	yox
dura	drq
iyayu	iya
agoi	ibm
kamasau	kms
tarpia	tpf
cheremis	mhr
kande	kbs
bigambal	xbe
lenakel	tnl
adivasi oriya	ort
suundi	sdj
lahanan	lhn
brem	buq
banaro	byz
eastern maninkakan	emk
guhu-samane	ghs
mandarin	cmn
pe	pai
khua	xhv
cofan	con
dharumbal	xgm
camling	rab
zambian sign language	zsl
au	avt
likuba	kxx
bishuo	bwh
even	eve
central mam	mvc
nume	tgs
bardi	bcj
malayo	mbp
hamea	cir
northeast maidu	nmu
mpur	akc
singapore sign language	sls
tomini	txm
tigrinya	tir
dangaura tharu	thl
kowaki	xow
humene	huf
wewaw	wea
southern qiang	qxs
baluan-pam	blq
southern nambikuara	nab
yetfa	yet
dagoman	dgn
east makian	mky
iwal	kbm
ibatan	ivb
varisi	vrs
mahongwe	mhb
bu-nao bunu	bwx
ilwana	mlk
southwestern huishui miao	hmh
andoque	ano
sipacapense	qum
pongu	png
jaunsari	jns
ashkun	ask
chidigo	dig
darmiya	drd
balanta-ganja	bjt
central cagayan agta	agt
selee	snw
marind	mrz
natioro	nti
massalat	mdg
bitur	mcc
west ambae	nnd
chonyi-dzihana-kauma	coh
ngazidja comorian	zdj
ayabadhu	ayd
yue chinese	yue
yong	yno
oruma	orr
yinchia	yin
saparua	spr
yukatek	yua
inebu one	oin
gabrielino-fernandeno	xgf
awara	awx
tasmate	tmt
vono	kch
ngul	nlo
palula	phl
lala-bisa	leb
iha based pidgin	ihb
gumuz	guk
khlula	ykl
nzakambay	nzy
pare	ppt
chocangacakha	cgk
thompson	thp
luba-katanga	lub
koitabu	kqi
papitalai	pat
drehu	dhv
phai	prt
fon	fon
nisi	yso
wathawurrung	wth
roon	rnn
shawnee	sjw
bobot	bty
doga	dgg
delo	ntr
kiowa	kio
moji	ymi
carolina algonquian	crr
takua	tkz
bolgarian	xbo
koonzime	ozm
tubar	tbu
northern mashan miao	hmp
ngawn chin	cnw
ngalum	szb
tena	bfe
zaysete	zay
uduk	udu
maasina fulfulde	ffm
lamenu	lmu
pattani malay	mfa
tagargrent	oua
mundabli	boe
paici	pri
kisar	kje
kimaghima	kig
jibu	jib
kakanda	kka
sausi	ssj
kwambi	kwm
nubi	kcn
ndemli	nml
south ndebele	nbl
yangkam	bsx
kullu pahari	kfx
chimalapa zoque	zoh
dari	gbz
tugun	tzn
wandarang	wnd
kankanaey	kne
turaka	trh
wergaia	weg
pawnee	paw
hamtai	hmt
noy	noy
pak-tong	pkg
waboda	kmx
firan	fir
sarangani manobo	mbs
southeast pashayi	psi
mian	mpt
latvian sign language	lsl
maay	ymm
gbanu	gbv
doondo	dde
taabwa	tap
gagu	ggu
masana	mcn
rawat	jnl
herero	her
mili	ymh
purubora	pur
kurux	kxl
thaiphum chin	cth
ngundu	nue
pam	pmn
punan bah-biau	pna
ngindo	nnq
pecheneg	xpc
tairaha	bxa
ulumanda'	ulm
seko padang	skx
bokyi	bky
lungga	lga
duano	dup
suki	sui
monzombo	moj
awtuw	kmn
saudi arabian sign language	sdl
lampung api	ljp
biali	beh
gibanawa	gib
central maewo	mwo
mbe'	mtk
xavante	xav
chilcotin	clc
ahirani	ahr
da'a kaili	kzf
occidental	ile
southern tutchone	tce
tepecano	tep
mom jango	ver
ramopa	kjx
kawe	kgb
toba-maskoy	tmf
kulisusu	vkl
saidi arabic	aec
danu	dnv
budong-budong	bdx
kaskean	zsk
malalamai	mmt
grangali	nli
wailapa	wlr
kusu	ksv
yongbei zhuang	zyb
western kanjobal	knj
marovo	mvo
hunnic	xhc
totontepec mixe	mto
papi	ppe
southern thai	sou
upper kinabatangan	dmg
termanu	twu
yaweyuha	yby
nyawaygi	nyt
hittite	hit
haryanvi	bgc
berakou	bxv
watubela	wah
chiltepec chinantec	csa
gorakor	goc
northwestern dinka	diw
numidian	nxm
northern catanduanes bikol	cts
varli	vav
ethiopian sign language	eth
kanashi	xns
sikaiana	sky
biri	bzr
garo	grt
dhalandji	dhl
albanian sign language	sqk
quetzaltepec mixe	pxm
baatonum	bba
samay	syx
ava-canoeiro	avv
hadrami arabic	ayh
tamnim citak	tml
koyraboro senni songhai	ses
mbangi	mgn
masikoro malagasy	msh
walio	wla
enets	enh
sudovian	xsv
ayi	ayq
kola	kvv
domu	dof
razihi	rzh
giangan	bgi
tunia	tug
tai daeng	tyr
mahali	mjx
biloxi	bll
mulaha	mfw
nyamwezi	nym
kashaya	kju
northern oaxaca nahuatl	nhy
yao samsao	ium
wuvulu-aua	wuv
kohin	kkx
awar	aya
kalabra	kzz
mbule	mlb
cebuano	ceb
terei	buo
lillooet	lil
malo	mla
daonda	dnd
bouyei	pcc
mescalero-chiricahua apache	apm
mubami	tsx
tupuri	tui
parkwa	pbi
kayeli	kzl
central huishui miao	hmc
ujir	udj
bendi	bct
sarasira	zsa
onge	oon
indus valley language	xiv
lamang	hia
totomachapan zapotec	zph
powhatan	pim
jingpo	kac
chadian arabic	shu
tuamotuan	pmt
rinconada bikol	bto
ajawa	ajw
tunica	tun
yang zhuang	zyg
torres strait creole	tcs
s'gaw karen	ksw
kaco'	xkk
guramalum	grz
mota	mtt
west damar	drn
paniya	pcg
kandas	kqw
mbowe	mxo
chuanqiandian cluster miao	cqd
sawai	szw
puri	prr
chorasmian	xco
mairasi	zrs
serbian	srp
bable	ast
ukwuani-aboh-ndoni	ukw
teke-laali	lli
machame	jmc
secoya	sey
nkoroo	nkx
tanglang	ytl
khorezmian	zkh
nyelayu	yly
mohave	mov
kucong	lkc
southern tiwa	tix
tamazight	tzm
assamese	asm
medumba	byv
umbundu	umb
east nyala	nle
rajah kabunsuwan manobo	mqk
bisorio	bir
pyen	pyy
biseni	ije
lopi	lov
tabriak	tzx
jiongnai bunu	pnu
nanubae	afk
southern catanduanes bikol	bln
loniu	los
ga'dang	gdg
vlaamse gebarentaal	vgt
mattole	mvb
algonquian	crr
yasa	yko
hulaula	huy
wasembo	gsp
yaosakor asmat	asy
mursi	muz
mandingo	man
ubaghara	byc
bau bidayuh	sne
sa'och	scq
panamanian sign language	lsp
kupa	kug
hahon	hah
panamint	par
turkana	tuv
pekal	pel
waata	ssn
northeastern dinka	dip
northern thai	nod
loke	loy
mayi-yapi	xyj
chacobo	cao
kurti	ktm
avau	avb
taveta	tvs
algerian sign language	asp
upper ta'oih	tth
eastern balochi	bgp
queretaro otomi	otq
anuki	aui
akkadian	akk
harami	xha
inuktitut	ike
kistane	gru
khun	kkh
yintale	kvy
kathoriya tharu	tkt
koguryo	zkg
oneida	one
arma	aoh
achagua	aca
south fali	fal
rajput garasia	gra
sassarese sardinian	sdc
kannada kurumba	kfi
sumi naga	nsm
tugen	tuy
haisla	has
bangka	mfb
panasuan	psn
manding	man
teke-nzikou	nzu
hmong shua	hmz
nakanai	nak
pilaga	plg
spanish + english	eng
edo	bin
kagoro	xkg
negeri sembilan malay	zmi
ainbai	aic
chothe naga	nct
adara	kad
paranawat	paf
loun	lox
koresh-e rostam	okh
puerto rican sign language	psl
tidore	tvo
tunisian arabic	aeb
bassa-kontagora	bsr
irarutu	irh
miwa	vmi
pushto	pus
gamkonora	gak
rampi	lje
magahi	mag
nuk	noc
southern roglai	rgs
liki	lio
karko	kko
doyayo	dow
tagdal	tda
mainfrankisch	vmf
western bru	brv
yimas	yee
unami	unm
gula'alaa	gmb
njerep	njr
kula	tpg
capiznon	cps
quinqui	quq
miu	mpo
holu	hol
ginyanga	ayg
baygo	byg
bhoti kinnauri	nes
waling	wly
maltese sign language	mdl
westphalien	wep
island carib	crb
konongo	kcz
butuanon	btw
deno	dbb
bura-pabir	bwr
teop	tio
yala	yba
minz zhuang	zgm
kenzi	xnz
somyev	kgt
pokomo	pkb
takuu	nho
toram	trj
djangun	djf
taimyr pidgin russian	???
corongo ancash quechua	qwa
algerian saharan arabic	aao
duungooma	dux
south giziga	giz
mangole	mqc
big nambas	nmb
ndoe	nbb
gyem	gye
idate	idt
suga	sgi
nobiin	fia
luganda	lug
biete	biu
urumi	uru
basque	eus
xiang chinese	hsn
linear a	lab
baimak	bmx
western cham	cja
wichita	wic
larevat	lrv
laba	lau
wamin	wmi
landoma	ldm
pass valley yali	yac
colombian sign language	csn
besoa	bep
neko	nej
imbabura highland quichua	qvi
bukit malay	bvu
sudanese creole arabic	pga
macedonian	mkd
northwestern fars	faz
teso	teo
southwestern tlaxiaco mixtec	meh
dirasha	gdl
lambadi	lmn
shuadit	sdt
fiwaga	fiw
lamatuka	lmq
early high german	???
kamara	jmr
olulumo-ikom	iko
retta	ret
kwamera	tnk
south marquesan	mqm
solong	aaw
western juxtlahuaca mixtec	jmx
batak simalungun	bts
ofaye	opy
matis	mpq
ami	amy
mt. iriga agta	agz
kavalan	ckv
carrier	crx
port vato	ptv
chini	afi
labir	jku
piapoco	pio
muyuw	myw
yawalapiti	yaw
ukit	umi
eastern apurimac quechua	qve
southern yamphu	lrr
bainouk-gunyaamolo	bcz
egyptian	arz
jurchen	juc
northern puebla nahuatl	ncj
arpitan	frp
tumak	tmc
yaqay	jaq
aguano	aga
waorani	auc
zialo	zil
burusu	bqr
timne	tem
kuot	kto
wejewa	wew
lundayeh	lnd
valle nacional chinantec	cvn
limburgish	lim
beele	bxq
bhilali	bhi
aka-kol	aky
ahan	ahn
bonjo	bok
kalkutungu	ktg
tunni	tqq
halh mongolian	khk
watam	wax
akan	aka
bakaka	bqz
jakati	jat
hazaragi	haz
weri	wer
likwala	kwc
eki	eki
atsugewi	atw
lua'	prb
tutelo	tta
bagirmi	bmi
daga	dgz
mayoyao ifugao	ifu
papua new guinean sign language	pgz
bacama	bcy
tlachichilco tepehua	tpt
tenharim	pah
betta kurumba	xub
obispeno	obi
yaqui	yaq
northern tidung	ntd
tahltan	tht
namakura	nmk
hadrami	xhd
nande	nnb
ulithian	uli
domung	dev
bauria	bge
obanliku	bzy
songomeno	soe
yagaria	ygr
naba	mne
subiya	sbs
ojibwa	otw
taushiro	trr
senara senoufo	seq
daro-matu melanau	dro
arbore	arv
eastern keres	kee
colonial valley zapotec	???
mid-southern banda	bjo
bragat	aof
uspanteco	usp
qiang	cng
arumanian	rup
tijaltepec mixtec	xtl
ute-southern paiute	ute
greenlandic	kal
punan batu 1	pnm
central dusun	dtp
guambiano	gum
merei	lmb
garre	gex
karelian	krl
sekpele	lip
brazilian portuguese	por
northwest pashayi	glh
erave	kjy
sidetic	xsd
shumashti	sts
gilaki	glk
mangareva	mrv
urubu-kaapor	urb
loncong	lce
selangor sign language	kgi
esselen	esq
tetela	tll
kuku-yalanji	gvn
baangi	bqx
harijan kinnauri	kjo
ansus	and
garus	gyb
ayerrerenge	axe
monoalu	mte
wandji	wdd
northern pashto	pbu
bininj gun-wok	gup
miao	blu
southern east cree	crj
paynamar	pmr
quileute	qui
changriwa	cga
sheko	she
maya samo	sym
lolak	llq
cross river mbembe	mfn
batuley	bay
paasaal	sig
kutto	kpa
nyamal	nly
attie	ati
samatao	ysd
ocotepec mixtec	mie
walak	wlw
remo	rem
ha	haq
angami naga	njm
amarasi	aaz
isanzu	isn
seluwasan	sws
asturian	ast
aralle-tabulahan	atq
tacana	tna
morokodo	mgc
sowa	sww
mumuye	mzm
sunwar	suz
southeast ambrym	tvk
omotik	omt
ipili	ipi
asheninka	cni
okanagan	oka
wemale	weo
mangbutu	mdk
abanyom	abm
wik-mungkan	wim
poule	msl
yabaana	ybn
bekwarra	bkv
bulgebi	bmp
paluan	plz
fagani	faf
latgalian	ltg
kendayan	knx
pamplona atta	att
berinomo	bit
mitlatongo mixtec	vmm
caribbean hindustani	hns
kwerisa	kkb
nete	net
tsaangi	tsa
foau	flh
waioli	wli
panchpargania	tdb
pitta pitta	pit
ngadjuri	jui
bhujel	byh
sara	sre
mong njua	hnj
mi'kmaq	mic
haeke	aek
bassari	bsc
mosimo	mqv
gafat	gft
southeastern pomo	pom
ma'ya	slz
alagwa	wbj
bayali	bjy
phuza	ypz
north wahgi	whg
nootka	noo
selaru	slu
yekora	ykr
piemontese	pms
sape	spc
mokilese	mkj
lamkang	lmk
sinsauru	snz
deni	dny
bagvalal	kva
munggui	mth
lakalei	lka
tuxinawa	tux
parenga	pcj
guiberoua bete	bet
kolsch	ksh
luwati	luv
penchal	pek
mbre	mka
ngbaka ma'bo	nbm
hunsrik	hrx
tarjumo	txj
fataleka	far
pa'a	pqa
jora	jor
hanoi sign language	hab
iaai	iai
phu thai	pht
avava	tmb
ometepec nahuatl	nht
wik-ngathana	wig
bauzi	bvz
wanggom	wng
grenadian creole english	gcl
keliko	kbo
dogul dom dogon	dbg
navajo	nav
gun	guw
nekgini	nkg
hixkaryana	hix
balkan romani	rmn
makhuwa-saka	xsq
kepo'	kuk
lefa	lfa
lycian	xlc
duke	nke
koi	kkt
banda-bambari	liy
masaaba	myx
dompo	doy
yindjibarndi	yij
defaka	afn
bondoukou kulango	kzc
ngiti	niy
haitian creole	hat
vaeakau-taumako	piv
carabayo	cby
kokota	kkk
koch	kdq
weme gbe	wem
makasar	mak
baybayanon	bvy
straits salish	str
nepali	nep
british sign language	bfi
laa laa bwamu	bwj
waimaha	bao
galeya	gar
bana	bcw
tajiki arabic	abh
catalan sign language	csc
eipomek	eip
keapara	khz
kelabit	kzi
dupaninan agta	duo
komyandaret	kzv
epena	sja
pei	ppq
asuncion mixtepec zapotec	zoo
titan	ttv
yangum gel	ygl
gilbertese	gil
tiene	tii
teochew	nan
seroa	kqu
kinga	zga
maru	mhx
northeastern pomo	pef
daho-doo	das
pampanga	pam
mandari	mqu
tumzabt	mzb
yinggarda	yia
kubo	jko
surui	sru
rohingya	rhg
maringarr	zmt
uisai	uis
manipa	mqp
sri lankan creole malay	sci
luopohe hmong	hml
kwalhioqua-tlatskanai	qwt
hruso	hru
korana	kqz
danish sign language	dsl
khoibu naga	nkb
ritarungo	rit
diyari	dif
korean sign language	kvk
nding	eli
chadong	cdy
noiri	noi
kamberau	irx
lorang	lrn
sagalla	tga
azha	aza
ranglong	rnl
kemiehua	kfj
leinong naga	lzn
anyin morofo	mtb
pangasinan	pag
oniyan	bsc
breri	brq
ghomala'	bbj
yangman	jng
yorta yorta	xyy
kazukuru	kzk
parthian	xpr
skepi creole dutch	skw
hamer-banna	amf
chimila	cbg
benga	bng
ikulu	ikl
shekkacho	moy
pirriya	xpa
eastern hongshuihe zhuang	zeh
zimba	zmb
guliguli	gli
singpho	sgp
dogoso	dgs
kulfa	kxj
dieri	dif
latu	ltu
sea island creole english	gul
romani	rmn
bungu	wun
mayawali	yxa
karnai	bbv
tombelala	ttp
guibian zhuang	zgn
saya	say
mesqan	mvz
ririo	rri
nyali	nlj
kariyarra	vka
wolani	wod
gurung	gvr
saisiyat	xsy
banda-ndele	bfl
ixtenco otomi	otz
vures	msn
apalachee	xap
tetun dili	tdt
gbaya-mbodomo	gmm
maricopa	mrc
boghom	bux
boma	boh
barrow point	bpt
somali	som
rotuman	rtm
akei	tsr
mohawk	moh
loup b	xlb
karuwali	rxw
manchu	mnc
jalkunan	bxl
ninggerum	nxr
wolane	wle
joba	job
agwagwune	yay
watakataui	wtk
piu	pix
ngambay	sba
ding	diz
dagba	dgk
guerrero nahuatl	ngu
fanbak	fnb
bathari	bhm
guevea de humboldt zapotec	zpg
bwaidoka	bwd
dotyali	dty
wolof	wol
welsh	cym
uradhi	urf
nage	nxe
gnau	gnu
madngele	zml
tondano	tdn
afra	ulf
yup'ik	esu
cakchiquel-quiche mixed language	ckz
nchumbulu	nlu
iha	ihp
francoprovencal	frp
tjurruru	tju
lezgian	lez
sukur	syk
duruwa	pci
mokerang	mft
iquito	iqu
northeastern thai	tts
purik	prx
biem	bmc
classical armenian	xcl
mandjak	mfv
boo	bqc
nunggubuyu	nuy
hung	hnu
nigerian pidgin	pcm
mangayat	myj
beja	bej
batad ifugao	ifb
gwahatike	dah
marshallese	mah
santa maria quiegolani zapotec	zpi
urali	url
bilma kanuri	bms
lao naga	nlq
white lachi	lwh
gureng gureng	gnr
hadothi	hoj
saponi	spi
naro	nhr
southeastern dinka	dks
andaman creole hindi	hca
ubykh	uby
vietnamese	vie
nukna	klt
bata	bta
bharia	bha
kanite	kmu
kanowit-tanjong melanau	kxn
kumarbhag paharia	kmj
clallam	clm
bayono	byl
birao	brr
korwa	kfp
sayula popoluca	pos
gata'	gaq
fwe	fwe
bum	bmv
cheq wong	cwg
southern samo	sbd
yalahatan	jal
sonsorol	sov
langbashe	lna
jiarong	jya
khirwar	kwx
ngile	jle
lak	lbe
fulah	ful
ibali teke	tek
eastern katu	ktv
dubu	dmu
axamb	ahb
sara kaba naa	kwv
daatsʼiin	dtn
sanglechi	sgy
northwestern nisu	nsf
mozarabic	mxi
igala	igl
southeast ijo	ijs
kongo	kng
gende	gaf
ivatan	ivv
mamainde	wmd
kyenele	kql
muya	mvm
temuan	tmw
burduna	bxn
leonese	ast
ngete	nnn
korur	auq
olukhayo	lko
bhele	bhy
northern ngbandi	ngb
taromi	tov
lese	les
zarphatic	zrp
auye	auu
purisimeno	puy
bhalay	bhx
gadsup	gaj
bube	bvb
naka'ela	nae
umiray dumaget agta	due
kagate	syw
ladji ladji	llj
santo domingo albarradas zapotec	zas
east futuna	fud
kumukio	kuo
kang	kyp
madagascar sign language	mzc
koluwawa	klx
kafoa	kpu
olo	ong
gagadu	gbu
papora	ppu
ma manda	skc
kaan	ldl
songhai	ses
uamue	uam
bunun	bnn
animere	anf
sorsogon ayta	ays
bangla	ben
kanikkaran	kev
singa	sgm
yupik	esu
bullom so	buy
tagish	tgx
obokuitai	afz
jiba	juo
dani	dnw
zumaya	zuy
tinani	lbf
jola-kasa	csk
karachay-balkar	krc
lega	lea
chaura	crv
samei	smh
rifao	nmw
khakas	kjh
kashmiri	kas
bilba	bpz
middle low german	gml
safwa	sbk
erromintxela	emx
na	nbt
sanie	ysy
aheri gondi	esg
ambul	apo
tremembe	tme
ghanaian pidgin english	???
warungu	wrg
ndumu	nmd
warao	wba
comaltepec chinantec	cco
moose cree	crm
northwest alaska inupiatun	esk
mao naga	nbi
maca	mca
engdewu	ngr
ingrian	izh
tamasheq	taq
mayaguduna	xmy
leco	lec
old french	fro
tayabas ayta	ayy
selungai murut	slg
sochiapam chinantec	cso
dogon	dds
curripaco	kpc
yapunda	yev
biga	bhc
ndunga	ndt
nyamusa-molo	nwm
wamas	wmc
pande	bkj
hula	hul
mafa	maf
jur modo	bex
lengua de senas del paraguay	pys
lowland oaxaca chontal	clo
volapuk	vol
lasalimu	llm
mzieme naga	nme
kadai	kzd
inuit	ike
nawuri	naw
reel	atu
providencia sign language	prz
thakali	ths
piratapuyo	pir
vata + gbadi	btg
yaygir	xya
katla	kcr
kamar	keq
tay	tyz
san lucas quiavini zapotec	zab
phudagi	phd
pittapitta	pit
buraka	bkg
lingua franca	pml
terik	tec
nottoway-meherrin	nwy
niuean	niu
shanga	sho
elepi	ele
resigaro	rgr
salako	knx
kon keu	kkn
northwestern tamang	tmk
namla	naa
gallurese sardinian	sdn
ede ica	ica
nateni	ntm
ubir	ubr
awu	yiu
songway kiini	tst
torona	tqr
koki naga	nxk
mittimatalik	ike
etchemin	etc
tagbu	tbm
zizilivakan	ziz
makah	myh
leipon	lek
nyala	nle
nsenga	nse
umbugarla	umr
putai	mfl
angkamuthi	avm
sininkere	skq
waris	wrs
baga kaloum	bqf
manx	glv
coatlan mixe	mco
kapampangan	pam
weh	weh
khmu	kjg
nda'nda'	nnz
pochutec	xpo
ghandruk sign language	gds
loloda	loa
bomboma	bws
ak	nog
hoyahoya	hhy
sao paulo kaingang	zkp
yeni	yei
boko	bqc
upper taromi	tov
merwari	wry
thado chin	tcz
petapa zapotec	zpe
bainouk-samik	bcb
ewe	ewe
mongolia buriat	bxm
chewa	nya
tanjijili	uji
katcha-kadugli-miri	xtc
timugon murut	tih
label	lbb
balaesang	bls
tuxa	tud
hurrian	xhu
southeast pashai	psi
kintaq	knq
southern yukaghir	yux
baan	bvj
cayubaba	cyb
laal	gdm
cypriot arabic	acy
oroko	bdu
wanda	wbh
guibei zhuang	zgb
isthmus mixe	mir
ava guarani	nhd
siang	sya
ribun	rir
aghwan	xag
pukapuka	pkp
mezontla popoloca	pbe
wandala	mfi
matigsalug manobo	mbt
samarokena	tmj
laadan	ldn
choapan zapotec	zpc
chimariko	cid
onjob	onj
old high german	goh
southern pashto	pbt
amele	aey
tambotalo	tls
kura ede nago	nqk
kosena	kze
vili	vif
mae	mme
judeo-tunisian arabic	ajt
angal heneng	akh
bote-majhi	bmj
khanty	kca
wanga	lwg
pakaasnovos	pav
themne	tem
cumanagoto	cuo
huehuetla tepehua	tee
digaro-mishmi	mhu
nafusi	jbn
sok	skk
barang-barang	lji
ndra'ngith	dgt
garhwali	gbm
serbocroatian	hrv
meroitic	xmr
achi	acr
piya-kwonci	piy
gurdjar	gdj
san juan guelavia zapotec	zab
vinza	vin
tampulma	tpm
liangmai naga	njn
northern sotho	nso
madi	grg
defi gbe	gbh
mawak	mjj
susquehannock	sqn
dongolawi	dgl
qimant	ahg
andai	afd
bolgo	bvo
gamale kham	kgj
eastern yiddish	ydd
mangseng	mbh
iamalele	yml
tobo	tbv
pitjantjatjara	pjt
djimini senoufo	dyi
western kayah	kyu
podena	pdn
sango	sbp
jirel	jul
asilulu	asl
abu' arapesh	aah
sawila	swt
korowai	khe
jamaican country sign language	jcs
michigamea	cmm
sikule	skh
reli	rei
icelandic	isl
ndunda	nuh
umotina	umo
kadiweu	kbc
ugaritic	uga
timor pidgin	tvy
southern pastaza quechua	qup
marriammu	xru
makasae	mkz
juma	jua
east tarangan	tre
majang	mpe
doromu-koki	kqc
mwali comorian	wlc
mori bawah	xmz
western mari	mrj
seselwa creole french	crs
mbere	mdt
crow	cro
malol	mbk
tsikimba	kdl
lisabata-nuniali	lcs
sikiana	sik
bahnar	bdq
tobati	tti
yandjibara	xyb
repanbitip	rpn
ticuna	tca
ziriya	zir
nupode huitoto	hux
tsuvadi	tvd
sighu	sxe
kanyok	kny
holiya	hoy
berom	bom
vaghat-ya-bijim-legeri	bij
borei	gai
nai	bio
dagik	dec
ilongot	ilk
mlahso	lhs
meta'	mgo
chetco	ctc
swahili	swh
gade	ged
kaike	kzq
mongol	mgt
gwandara	gwn
nauna	ncn
oromo	gax
chinook	chh
tandaganon	tgn
rade	rad
tira	tic
manado malay	xmm
gandhari	pgd
bidyogo	bjg
nokuku	nkk
talaud	tld
akpa	akf
acipa	acp
onin	oni
olushisa	lks
tring	tgq
rapa	ray
ju	juu
achang	acn
mulgi	mvh
venetic	xve
shabak	sdb
logudorese sardinian	src
gizrra	tof
komering	kge
ngalakan	nig
bawm chin	bgr
youjiang zhuang	zyj
toro tegu dogon	dtt
mala malasar	ima
lingarak	lgk
bwela	bwl
east yugur	yuy
kayapa kallahan	kak
lachiguiri zapotec	zpa
gudanji	nji
swedish	swe
nabak	naf
madhi madhi	dmd
kurmukar	kfv
shuwa-zamani	ksa
jandavra	jnd
northern tiwa	twf
banam bay	vrt
kaxuiana	kbb
gadang	gdk
demta	dmy
prussian	prg
owa	stn
mpotovoro	mvt
tubatulabal	tub
vute	vut
pahi	lgt
mabaka valley kalinga	kkg
moksela	vms
kunimaipa	kup
eastern khumi chin	cek
gulay	gvl
mbole	mdq
zimakani	zik
cubeo	cub
lavukaleve	lvk
romblomanon	rol
kirike	okr
dzongkha	dzo
tanggu	tgu
wolaytta	wal
pankararu	paz
mexican sign language	mfs
dzando	dzn
sauri	srt
kenyang	ken
late middle chinese	ltc
metlatonoc mixtec	mxv
moklen	mkm
ci gbe	cib
marubo	mzr
bambassi	myf
saaroa	sxr
northern huishui miao	hmi
modern greek	ell
choni	cda
bongu	bpu
atsahuaca	atc
dambi	dac
bantayanon	bfx
nomaande	lem
koyra chiini	khq
ganda	lug
alabama	akz
gwamhi-wuri	bga
bunganditj	xbg
cholon	cht
wadjabangayi	wdy
yagua	yad
akawaio	ake
goundo	goy
itundujia mixtec	mce
gothic	got
eastern karaboro	xrb
cao lan	mlc
rabha	rah
huaylas ancash quechua	qwh
nkonya	nko
baibai	bbf
bolon	bof
duwet	gve
olunyole	nyd
kutong	skm
uyghur	uig
havasupai-walapai-yavapai	yuf
cocopa	coc
umbu-ungu	ubu
gedeo	drs
elotepec zapotec	zte
akoose	bss
silopi	xsp
albanian	als
shumcho	scu
southern kurdish	sdh
nepali kurux	kxl
cineni	cie
talodi	tlo
ede ije	ijj
eastern penan	pez
kuni-boazi	kvg
mannan	mjv
bolivian sign language	bvl
wan	wan
turi	trd
emilian	egl
ngasa	nsg
leelau	ldk
cen	cen
agutaynen	agn
sandawe	sad
bimoba	bim
zaniza zapotec	zpw
blafe	bfh
sangil	snl
olrat	olr
okpamheri	opa
lemio	lei
belize kriol english	bzj
tilapa otomi	otl
dar daju daju	djc
abe	aba
south lembata	lmf
nukunul	xnu
undetermined	und
vasavi	vas
cwi bwamu	bwy
tacahua mixtec	xtt
wab	wab
elymian	xly
cotabato manobo	mta
kwere	cwe
lau	llu
a-hmaos	hmd
suarmin	seo
yansi	yns
rawang	raw
iteri	itr
awbono	awh
gal	gap
tonsea	txs
mang	zng
mochi	old
standard malay	zsm
sidamo	sid
brokkat	bro
moyon naga	nmo
rincon zapotec	zar
malankuravan	mjo
yolŋu sign language	ygs
tangale	tan
slave	xsl
quinault	qun
dhangu	dhg
tokano	zuh
quapaw	qua
zemgalian	xzm
northern sami	sme
vaghri	vgr
djiwarli	dze
konda-dora	kfc
pular	fuf
eastern ojibwa	ojg
yangulam	ynl
singapore malay	mly
aimaq	aiq
roma	rmm
cua	cua
kurichiya	kfh
northern altai	atv
abkhazian	abk
korku	ksz
squamish	squ
newar	new
awa	awb
philippine sign language	psp
tunjung	tjg
kwaza	xwa
yora	mts
papuan malay	pmy
gapapaiwa	pwg
hadiyya	hdy
sop	urw
mundani	mnf
kangiryuarmiut	ikt
tocho	taz
not applicable	zxx
wae rana	wrx
inupiaq	esi
momare	msz
rerau	rea
nihali	nll
bushoong	buf
elkei	elk
yalalag zapotec	zpu
karipuna creole french	kmv
aroplokep	apr
palauan	pau
shixing	sxg
likila	lie
dogose	dos
nyalayu	yly
estado de mexico otomi	ots
mehinaku	mmh
halang	hal
senhaja de srair	sjs
tarahumara	tar
songhay	ses
kuturmi	khj
sinicized miao	hmz
marachi	lri
karami	xar
katkari	kfu
northern frisian	frr
tenggarong kutai malay	vkt
honduras sign language	hds
neverver	lgk
ngbaka	nga
tai thanh	tmm
chochotec	coz
adilabad gondi	wsg
romany	rmn
spanish sign language	ssp
bandi	bza
mamulique	emm
nedebang	nec
janji	jni
mangala	mem
chibcha	chb
fembe	agl
degenan	dge
bodo gadaba	gbj
teke-tyee	tyx
mirandese	mwl
aghul	agx
wamey	cou
lole	llg
tringgus-sembaan bidayuh	trx
yanomami	wca
ngelima	agh
punan aput	pud
rembarunga	rmb
tareng	tgr
vaagri booli	vaa
loup a	xlo
dimasa	dis
xaragure	axx
befang	bby
manide	abd
seneca	see
sicilian	scn
arawete	awt
zenaga	zen
yavitero	yvt
bikaru	bic
sobei	sob
bomitaba	zmx
jabuti	jbt
soyaltepec mazatec	vmp
benyadu'	byd
morouas	mrp
yir yoront	yyr
lo-toga	lht
tadyawan	tdy
north ambrym	mmg
ono	ons
southern rincon zapotec	zsr
garlali	gll
bilbil	brz
yoidik	ydk
khamyang	ksu
central melanau	mel
poqomchi'	poh
buhid	bku
memoni	mby
eggon	ego
eviya	gev
mafea	mkv
dyirbal	dbl
tsetsaut	txc
ts'un-lao	tsl
bari	bfa
taiap	gpn
nocte	njb
foi	foi
mochica	omc
vangunu	mpr
kalam	kmh
hungarian	hun
baki	bki
riantana	ran
kangjia	kxs
western highland purepecha	pua
old irish	sga
mburku	bbt
tai dam	blt
para naga	pzn
reshe	res
arawa	aru
borana-arsi-guji oromo	gax
arbereshe albanian	aae
hadza	hts
upper sorbian	hsb
gbesi gbe	gbs
noone	nhu
eruwa	erh
igo	ahl
eravallan	era
kwa'	bko
minidien	wii
chichimeca-jonaz	pei
kwa	kwb
yaben	ybm
ditidaht	noo
ngie	ngj
berti	byt
dibo	dio
maewo	mwo
kapinawa	xpn
macaguaje	mcl
remun	lkj
baha buyang	yha
middle irish	mga
ndogo	ndz
sebat bet gurage	sgw
banao itneg	bjx
bonkiman	bop
awa-cuaiquer	kwi
bintulu	bny
kung	kfl
gbin	xgb
ososo	oso
darkinyung	xda
konso	kxc
tuvalu	tvl
zarma	dje
dass	dot
ixcatlan mazatec	mzi
roviana	rug
vano	vnk
maram naga	nma
caddo	cad
amo	amo
lemoro	ldj
coahuilteco	xcw
kua	tyu
kukna	kex
south west bay	sns
nkhumbi	khu
olutsotso	lto
surigaonon	sgd
sekani	sek
mewari	mtr
xakriaba	xkr
punu	puu
akebu	keu
sa'ban	snv
highland oaxaca chontal	chd
roria	rga
angal enen	aoe
she	shx
cayuse	xcy
tai loi	tlq
we western	wec
matukar	mjk
hutterite german	geh
makhuwa-marrevone	xmc
tripuri	xtr
ancient macedonian	xmk
munit	mtc
cajun french	frc
dayak	xdy
western apache	apw
mekmek	mvk
messapic	cms
wotjobaluk	xwt
hasha	ybj
ong	oog
lowland tarahumara	tac
belait	beg
jauja wanca quechua	qxw
tay khang	tnu
bauwaki	bwk
maragus	mrs
beneraf	bnv
bankagooma	bxw
kung-ekoka	knw
siona	snn
papiamento	pap
biafada	bif
northern muji	ymx
alngith	aid
bola	bnp
interlingue	ile
valencian	cat
new zealand sign language	nzs
horo	hor
gaikundi	gbf
zumbun	jmb
dongshanba lalo	yik
gurani	hac
iu mien	ium
manombai	woo
chumburung	ncu
adabe	adb
gude	gde
womo	wmx
duupa	dae
mwani	wmw
kalkoti	xka
xukuru	xoo
hamap	hmu
molof	msl
mezquital otomi	ote
raetic	xrr
shubi	suj
rongmei naga	nbu
bubia	bbx
megleno romanian	ruq
kur	kuv
tauya	tya
dyula	dyu
tlacoatzintepec chinantec	ctl
teme	tdo
zari	zaz
central tarahumara	tar
lyngngam	lyg
kadazan dusun	dtp
tapeba	tbb
gurindji	gue
ternateno	tmg
cicipu	awc
miahuatlan zapotec	zam
matepi	mqe
so'a	ssq
zaparo	zro
ketangalan	kae
temascaltepec nahuatl	nhv
pnar	pbv
sechelt	sec
santa ines ahuatempan popoloca	pca
paama	pma
sa'a	apb
tatuyo	tav
kelo	xel
konai	kxw
embera-catio	cto
koho	kpm
sala	shq
omok	omk
uzekwe	eze
jiwarli	mem
mbesa	zms
'are'are	alu
zaza	diq
interlingua	ina
portuguese sign language	psr
ili turki	ili
makaa	mcp
shabo	sbf
angor	agg
ile ape	ila
tumulung sisaala	sil
tereweng	twg
zuojiang zhuang	zzj
western totonac	tqt
multiple languages	mul
irantxe	irn
simbo	sbb
dyangadi	dyn
bung	bqd
khengkha	xkf
hakha chin	cnh
cuzco quechua	quz
timbe	tim
south tairora	omw
vehes	val
viti	vit
east limba	lma
north russian romani	rml
samba	smx
sebuyau	snb
mariyedi	zmy
sou	sqq
ili'uun	ilu
sagala	sbm
kibet	kie
dia	dia
ngbinda	nbd
chokri naga	nri
dobel	kvo
kamviri	xvi
mser	kqx
eastern karnic	ekc
salish	str
meramera	mxm
kunduvadi	wku
nyenkha	neh
tupi	tpw
chiquitano	cax
cuba	cbq
southwestern dinka	dik
tamang	taj
o'chi'chi'	xoc
walloon	wln
ne ambae	omb
mulao	giu
guriaso	grx
bankan tey dogon	dbw
san mateo del mar huave	huv
nengone	nen
ajumbu	muc
tawallammat tamajaq	ttq
yug	yug
koyukon	koy
kw'adza	wka
bohtan neo-aramaic	bhn
dilling	dil
munduruku	myu
mbwela	mfu
lezghian	lez
paranan	prf
aruop	lsr
araki	akr
ganzi	gnz
koibal	zkb
east ambae	omb
romanova	rmv
kaninuwa	wat
hua	ygr
burun	bdi
patwin	wit
pintupi-luritja	piu
barro negro tunebo	tbn
adangme	ada
semnam	ssm
zaachila zapotec	ztx
southern sotho	sot
carijona	cbd
bantoanon	bno
mina	hna
mayo	mfy
santiago xanica zapotec	zpr
basap	bdb
yapese	yap
gela	nlg
pambia	pmb
ivbie north-okpela-arhe	atg
lower grand valley dani	dni
kharia	khr
khinalugh	kjj
interglossa	igs
safaliba	saf
kendeje	klf
chadian sign language	cds
irish	gle
ambae	omb
chopi	cce
bakpinka	bbs
bakole	kme
parakana	pak
arawum	awm
dolgan	dlg
nkutu	nkw
makonde	kde
nii	nii
borna	bwo
kenaboi	xbn
west lembata	lmj
negidal	neg
central tunebo	tuf
li'o	ljl
monom	moo
dawro	dwr
huachipaeri	hug
hako	hao
piaroa	pid
soi	soj
northeast pashayi	aee
kukatja	kux
kabuverdianu	kea
sheshi kham	kip
muluridyi	vmu
western lawa	lcp
mungaka	mhk
sakata	skt
mander	mqr
chokwe	cjk
serbian + croatian + bosnian	bos
friulian	fur
warji	wji
kugbo	kes
kugama	kow
danau	dnu
morerebi	xmo
nukuoro	nkr
marba	mpg
kita maninkakan	mwk
mandandanyi	zmk
north muyu	kti
yarawata	yrw
legenyem	lcc
sa	sax
carian	xcr
batyala	xby
sikkimese	sip
matya samo	stj
western fijian	wyy
acehnese	ace
central yupik	esu
anuak	anu
yidin	yii
southern hindko	hnd
changthang	cna
chippewa	ciw
tambora	xxt
semai	sea
senaya	syn
old occitan	pro
qau	gqu
yawiyo	ybx
sokoro	sok
jonkor bourmataguil	jeu
odiai	bhf
simbali	smg
n/u	ngh
peruvian sign language	prl
bonan	peh
drubea	duf
todrah	tdr
ruuli	ruc
mali	gcc
umpqua	xup
tagoi	tag
nguon	nuo
ho chi minh city sign language	hos
phala	ypa
ukuriguma	ukg
palenquero	pln
ciwogai	tgd
murupi	mqw
pacific gulf yupik	ems
mbya guarani	gun
french + moroccan arabic	ary
khe	kqg
ndau	ndc
foodo	fod
teen	lor
koropo	xxr
lucumi	luq
mwimbi-muthambi	mws
yalakalore	xyl
sasaru	sxs
yerukula	yeu
toba	tob
hijazi arabic	acw
tangoa	tgp
brokskat	bkk
calderon highland quichua	qud
dyaberdyaber	dyb
kala lagaw ya	mwp
northern paiute	pao
zaghawa	zag
chru	cje
yendang	ynq
/xam	xam
tayart tamajeq	thz
krisa	ksi
kaburi	uka
yango	yng
yuchi	yuc
batanga	bnm
duma	dma
nauete	nxa
circassian	ady
kohistani	mvy
amahai	amq
bebil	bxp
older english	ang
lobala	loq
yuqui	yuq
zerenkel	zrn
kagayanen	cgc
kupang malay	mkn
arigidi	aqg
wahau kayan	whu
udmurt	udm
ani phowa	ypn
pisidian	xps
hai//om	hgm
parawen	prw
chinbon chin	cnb
xanaguia zapotec	ztg
yelogu	ylg
tunggare	trt
baham	bdw
ganza	gza
kemtuik	kmt
oluwanga	lwg
ndaktup	ncp
kitsai	kii
tulehu	tlu
niksek	gbe
qatabanian	xqt
middle watut	mpl
chickasaw	cic
ikoma-nata-isenye	ntk
trinitario	trn
doe	doe
etruscan	ett
moere	mvq
ayizo gbe	ayb
helambu sherpa	scp
lubila	kcc
isthmus-mecayapan nahuatl	nhx
kyan-karyaw naga	nqq
samvedi	smv
mansaka	msk
gane	gzn
tikopia	tkp
gayo	gay
kachhi	kfr
wane	hwa
ndom	nqm
eleme	elm
maden	xmx
yanda dom dogon	dym
tepeuxila cuicatec	cux
kuni	kse
romanian	ron
malawi sena	swk
blin	byn
aribwaung	ylu
lahu shi	lhi
rudbari	rdb
kiowa apache	apk
nilamba	nim
cheyenne	chy
kofyar	kwl
kosare	kiq
gamo-ningi	bte
gorontalo	gor
koromira	kqj
fas	fqs
xingu asurini	asn
wutunhua	wuh
kinabatangan	dmg
old bulgarian	chu
aneityum	aty
nyahkur	cbn
woun meu	noa
rumu	klq
evant	bzz
nishnaabemwin	ojg
yanesha'	ame
ngaing	nnf
shinabo	snh
coptic	cop
sene	sej
kalarko	kba
dair	drb
bokha	ybk
lafofa	laf
zou	zom
alur	alz
tigre	tig
birwa	brl
akuku	ayk
yongnan zhuang	zyn
west goodenough	ddi
mgbolizhia	gmz
turk isaret dili	tsm
old turkish	otk
mandobo bawah	bwp
dhaiso	dhs
keley-i kallahan	ify
estonian	est
kachi koli	gjk
nasarian	nvh
bouna kulango	nku
maithili	mai
bwe karen	bwe
mbala	mdp
rayon zoque	zor
ipalapa amuzgo	azm
tlahuitoltepec mixe	mxp
konda	knd
simbari	smb
tomoip	tqp
zorop	wfg
tifal	tif
koma	kmy
hatam	had
indo-portuguese	idb
ejagham	etu
armenian sign language	aen
limburgan	lim
north levantine arabic	apc
pwo eastern karen	kjp
bashkardi	bsg
kobol	kgu
capanawa	kaq
southern uzbek	uzs
lower ta'oih	tto
carpathian romani	rmc
northern tujia	tji
northeast pashai	aee
morisyen	mfe
tabasco zoque	zoq
acatepec me'phaa	tpx
libyan sign language	lbs
frisian	fri
coeur d'alene	crd
gana	gnq
gugubera	kkp
urarina	ura
sorkhei	sqo
suku	sub
alumu-tesu	aab
melpa	med
nyankole	nyn
lithuanian sign language	lls
crioulo	pov
tlapanec	tcf
kolbila	klc
isabi	isa
serua	srw
kembayan	xem
tobelo	tlb
opao	opo
glavda	glw
koiwat	kxt
komba	kpf
masadiit itneg	tis
migaama	mmy
choctaw	cho
old english	ang
ngaju	nij
eastern lawa	lwl
pela	bxd
oksapmin	opm
gor	gqr
darai	dry
sindarin	sjn
buruwai	asi
khmer	khm
djauan	djn
tagin	tgj
jerung	jee
dutch	nld
yandruwandha	ynd
puluwatese	puw
ladakhi	lbj
ngbaka manza	ngg
middle armenian	axm
loarki	lrk
fania	fni
aasax	aas
moken	mwt
lamnso'	lns
amto	amt
nahavaq	sns
kosarek yale	kkl
lakota dida	dic
austrian sign language	asq
kwasio	nmg
kentish sign language	okl
efai	efa
northern nago	xkb
kwerba mamberamo	xwr
fanti	fat
yucateco	yua
tepinapa chinantec	cte
ulukwumi	ulb
kaikadi	kep
guduf-gava	gdf
s.sofia d'epiro	aae
nyabwa	nwb
vasekele	vaj
wurrugu	wur
bolo	blv
eitiep	eit
sissala	sld
tauade	ttd
crimean tatar	crh
otuho	lot
lusi	khl
ngarinman	nbj
kim	kia
nafri	nxx
eblan	xeb
malba birifor	bfo
osage	osa
zacatepec chatino	ctz
magɨyi	gmg
vaghua	tva
gyele	gyi
degexit'an	ing
mayeka	myc
ngombale	nla
taiwan sign language	tss
mamaa	mhf
ludian	lud
longgu	lgu
agariya	agi
tsucuba	cbq
lushai	lus
rufiji	rui
anaang	anw
bellari	brw
norn	nrn
laitu chin	clj
manambu	mle
papapana	ppn
kamwe	hig
baba	bbw
kaska	kkz
labu	lbu
kewa	kjs
ikobi	meb
kap	ykm
mayan	emy
al-sayyid bedouin sign language	syy
sinyar	sys
bebeli	bek
heiban	hbn
rukai	dru
molo	zmo
bissa	bib
areba	aea
kambiwa	xbw
frankish	frk
nong zhuang	zhn
butbut kalinga	kyb
copala triqui	trc
palaic	plq
lhaovo	mhx
liujiang zhuang	zlj
thurawal	tbh
jeng	jeg
judeo-italian	itk
tamazola mixtec	vmx
valley maidu	vmv
baissa fali	fah
yinbaw karen	kvu
liberian english	lir
ayutla mixtec	miy
mundang	mua
maco	wpc
turkic khalaj	klj
eastern xiangxi miao	muq
nahali	nlx
san blas kuna	cuk
central berawan	zbc
aghu-tharnggala	gtu
kwoma	kmo
maslam	msv
misima-panaeati	mpx
huba	hbb
central asmat	cns
letemboi	nms
tabasco nahuatl	nhc
german sign language	gsg
median	xme
southern pomo	peq
ngamo	nbh
sonia	siq
senthang chin	sez
haruai	tmd
oku	oku
phupa	ypp
martuyhunira	vma
west masela	mss
parya	paq
kaiy	tcq
ogbronuagum	ogu
kono	kno
kapingamarangi	kpg
talondo'	tln
atorada	aox
igwe	igw
marithiel	mfr
southern dagaare	dga
haya	hay
sebop	sib
nez perce	nez
koda	cdz
oluta popoluca	plo
tlacolula valley zapotec	zab
northwest gbaya	gya
south bavarian	bar
kusaal	kus
timbisha	par
gusii	guz
miltu	mlj
wantoat	wnc
anserma	ans
central bikol	bcl
ngamambo	nbv
akuntsu	aqz
evenki	evn
uma	ppk
rang	rax
daur	dta
setaman	stm
kachama-ganjule	kcx
katua	kta
nancere	nnc
pauserna	psm
folopa	ppo
haitian	hat
kwanga	kwj
to'abaita	mlu
zeem	zua
manggarai	mqy
pannei	pnc
italian sign language	ise
natchez	ncz
santa maria la alta nahuatl	nhz
yahadian	ner
nivacle	cag
kwaya	kya
malapandaram	mjp
maridan	zmd
belanda viri	bvi
mono	mnr
tseku	tsk
murle	mur
xadani zapotec	zax
ngantangarra	ntg
vera'a	vra
gade lohar	gda
panyjima	pnw
sicel	scx
baikeno	bkx
mbugwe	mgz
polish sign language	pso
lozi	loz
baharna arabic	abv
cahungwarya	nat
usila chinantec	cuc
kildin sami	sjd
miriti	mmv
san juan colorado mixtec	mjc
chuj	cac
baskisch	eus
ese	mcq
kimbu	kiv
crimean turkish	crh
inonhan	loc
dagaari dioula	dgd
narungga	nnr
wunai bunu	bwn
tedim chin	ctd
eteocypriot	ecy
kuku-muminh	xmh
uru	ure
chichewa	nya
gbanziri	gbg
mama	mma
kudiya	kfg
vandalic	xvn
ikposo	kpo
old marathi	omr
wahau kenyah	whk
okolod	kqv
ayangan ifugao	ifb
nkangala	nkn
niuafo'ou	num
unggumi	xgu
marfa	mvu
bualkhaw chin	cbl
yalarnnga	ylr
wirafed	wir
mandahuaca	mht
v'enen taut	nmb
massep	mvs
old russian	orv
quenya	qya
inari sami	smn
luba-lulua	lua
western lalu	ywl
bandjalang	bdy
karekare	kai
yelmek	jel
arikem	ait
tokelauan	tkl
duruma	dug
croatia sign language	csq
isebe	igo
wallisian	wls
pottangi ollar gadaba	gdb
tera	ttr
larike	alo
ida'an	dbj
sentani	set
paraguayan sign language	pys
adyghe	ady
pendau	ums
vestinian	xvs
virgin islands creole english	vic
ombo	oml
mbalanhu	lnb
maremgi	mrx
doutai	tds
soninke	snk
upper guinea crioulo	pov
istro romanian	ruo
chamari	cdg
camtho	cmt
zauzou	zal
kok-nar	gko
juxtlahuaca mixtec	vmc
amharic	amh
medieval greek	qgk
southeastern puebla nahuatl	nhs
eastern subanen	sfe
burak	bys
yukpa	yup
cacua	cbv
gwa	gwb
seta	stf
sindhi bhil	sbn
kannada	kan
eastern nisu	nos
nuuchahnulth	noo
saposa	sps
southern kalinga	ksc
mbosi	mdw
kraol	rka
sishee	sih
huaylla wanca quechua	qvw
pom	pmo
thuri	thu
sar	mwm
hoti	hti
old nubian	onw
selayar	sly
eshtehardi	esh
yankunytjatjara	kdd
kalanguya	kak
kunggari	kgl
seget	sbg
kxoe	xuu
south nuaulu	nxl
brokpake	sgt
kelon	kyo
bislama	bis
limilngan	lmc
udi	udi
sause	sao
wannu	jub
southwestern fars	fay
kwegu	xwg
huitepec mixtec	mxs
semaq beri	szc
chagatai	chg
gua	gwx
embera-baudo	bdc
sumerian	sux
dhurga	dhu
indri	idr
piraha	myp
ndobo	ndw
awadhi	awa
bali	ban
plateau malagasy	plt
owenia	wsr
anglo-norman	xno
ningera	nby
isnag	isd
canichana	caz
youle jinuo	jiu
ndamba	ndj
kyrgyz	kir
yugoslavian sign language	ysl
wa'ema	wag
aka-cari	aci
southern ghale	ghe
san felipe otlaltepec popoloca	pow
mullu kurumba	kpb
panim	pnr
lun bawang	lnd
kasanga	ccj
totoli	txe
cacaopera	ccr
penang sign language	psg
lauje	law
tapiete	tpj
dalabon	ngk
kwese	kws
takestani	tks
alyawarr	aly
dorig	wwo
cabiyari	cbb
olumarachi	lri
upper necaxa totonac	tot
kamang	woi
tlacolulita zapotec	zpk
saint lucian creole french	acf
kumyk	kum
sindhi	snd
gao	gga
maridjabin	zmj
tadaksahak	dsq
ngarla	nrk
makhuwa-meetto	mgh
salampasu	slx
ukrainian	ukr
acheron	acz
caramanta	crf
mambai	mcs
southern lolopo	ysp
pattapu	ptq
ngwaba	ngw
chengdu	iii
seze	sze
gaddi	gbk
bainouk-gunyuno	bab
guayabero	guo
northern guiyang miao	huj
tem	kdh
shelta	sth
mixtepec mixtec	mix
aranda	are
bidyara	bym
aka	soh
hindustani	hns
maiwala	mum
wumeng nasu	ywu
congo swahili	swc
jingpho	kac
northern yukaghir	ykg
kenyah	whk
lotha naga	njh
coyutla totonac	toc
baga sitemu	bsp
kwadi	kwz
nindi	nxi
nde-gbite	ned
eastern egyptian bedawi arabic	avl
heyo	auk
daakaka	bpa
abishira	ash
arapaso	arj
galo	adl
gamo	gmv
keiga	kec
samba daka	ccg
tonkawa	tqw
kalenjin	kln
yindjilandji	yil
swo	sox
tagalaka	tgz
ajiya	idc
surayt	tru
kabore one	onk
khotanese	kho
bian marind	bpv
polish	pol
guro	goa
southern ma'di	snm
puno quechua	qxp
nafaanra	nfr
jogi	jog
iceve-maci	bec
nigeria mambila	mzk
otoro	otr
dumun	dui
northern dong	doc
martuthunira	vma
tavoyan	tvn
lombo	loo
yao	yao
romkun	rmk
tembe	tqb
teor	tev
bunama	bdd
dororo	drr
silacayoapan mixtec	mks
limi	ylm
chaima	ciy
tlazoyaltepec mixtec	mqh
ndasa	nda
nambas	nmb
chiripa	nhd
barikewa	jbk
zhang-zhung	xzh
lydian	xld
ngala	nud
bangime	dba
turks and caicos creole english	tch
burumakok	aip
sepedi	nso
mandan	mhq
dzao min	bpn
sihan	snr
saleman	sau
tamajeq	thz
nyole	nuj
south levantine arabic	ajp
shipibo-conibo	shp
colonia tovar german	gct
lemolang	ley
ikwere	ikw
mesaka	iyo
abua	abn
tebul ure dogon	dtu
south muyu	kts
yamba	yam
nupe	nup
krobu	kxb
western mashan miao	hmw
miami	mia
kamayo	kyk
toraja-sa'dan	sda
nganasan	nio
tunisian sign language	tse
tofin gbe	tfi
sumbwa	suw
old avar	oav
turka	tuz
chetti	ctt
holma	hod
adamawa fulfulde	fub
rangpuri	rkt
lombi	lmi
mouwase	jmw
imperial aramaic	arc
southeast babar	vbb
tanacross	tcb
old welsh	owl
mazanderani	mzn
nayi	noz
southern birifor	biv
koshin	kid
runga	rou
old dutch	odt
central palawano	plc
kryts	kry
wedau	wed
waka	wav
qiubei zhuang	zqe
kosadle	kiq
maek	hmk
mopan maya	mop
klingon	tlh
mindiri	mpn
inpui naga	nkf
lohorung	lbr
ninam	shb
aoheng	pni
bete	biu
gawwada	gwd
toura	neb
siroi	ssd
sari	asj
cakchiquel	cak
dusun deyah	dun
lotud	dtr
maranunggu	zmr
aheu	thm
romansh	roh
sani	ysn
kungarakany	ggk
yahang	rhp
suganga	sug
nagumi	ngv
wikalkan	wik
yakaikeke	ykk
ngomba	jgo
polabian	pox
kwaami	ksq
yeniche	yec
dhao	nfa
lapaguia-guivini zapotec	ztl
twi	aka
manangba	nmm
tawande	xtw
bookan	bnb
djinang	dji
sabine	sbv
kho'ini	xkc
kuwaataay	cwt
phuie	pug
kansa	ksk
tarao naga	tro
garza	xgr
worrorra	wro
liberia kpelle	xpe
kemedzung	dmo
west kewa	kew
krio	kri
mixed great andamanese	gac
yamongeri	ymg
zay	zwa
assangori	sjg
north nuaulu	nni
lugbara	lgg
narak	nac
indus kohistani	mvy
thopho	ytp
djaru	ddj
mun chin	mwq
baba malay	mbf
wagawaga	wkw
jola-fonyi	dyo
libinza	liz
coatepec nahuatl	naz
bodo	brx
arop-lokep	apr
wa	wbm
krenak	kqq
sinhalese	sin
dzalakha	dzl
buwal	bhs
casiguran dumagat agta	dgc
sinagen	siu
old newari	nwc
lishan didan	trg
dungan	dng
mampruli	maw
naga pidgin	nag
balinese malay	mhp
omurano	omu
western subanon	suc
lamba	lam
elseng	mrf
abai sungai	abf
guadeloupean creole french	gcf
ngandi	nid
kutenai	kut
saamia	lsm
karenggapa	eaa
taruma	tdm
pwo western karen	pwo
huautla mazatec	mau
tabasco chontal	chf
nkongho	nkc
biatah bidayuh	bth
traveller danish	rmd
eritai	ert
phangduwali	phw
motlav	mlv
tena lowland quichua	quw
swati	ssw
maii	mmm
kein	bmh
yay	yoy
lingua franca nova	lfn
maring	mbw
garifuna	cab
classical mandaic	myz
shark bay	ssv
heiltsuk	hei
yurats	rts
kachari	xac
baima	bqh
mru	mro
malayic dayak	xdy
kambera	xbr
lacandon	lac
nachering	ncd
quechua	quz
comecrudo	xcm
jukun takum	jbu
cuba sign language	csf
bedoanas	bed
narom	nrm
ngkalmpw kanum	kcd
che	ruk
siawi	mmp
aka-bo	akm
nalogo	nlz
lumbee	lmz
tagwana senoufo	tgw
chontal	chd
sembakung murut	sbr
central tagbanwa	tgt
thangmi	thf
ambrak	aag
gbayi	gyg
karagas	kim
mano	mev
fulfulde	fuh
chug	cvg
wayanad chetti	ctt
rakhine	rki
caribbean javanese	jvn
laomian	lwm
sangir	sxn
vemgo-mabas	vem
hunzib	huz
marathi	mar
kara	nog
arin	xrn
walungge	ola
sibu melanau	sdx
wilawila	wil
sila	slt
shoshoni	shh
alaba-k’abeena	alw
modern dutch	nld
tojolabal	toj
bikya	byb
amanab	amn
rasawa	rac
kayapo	txu
dengese	dez
tundra enets	enh
karadjeri	gbd
dongotono	ddd
gunwinggu	gup
amdang	amj
bench	bcq
filomena mata-coahuitlan totonac	tlp
hinukh	gin
yabarana	yar
pataxo ha-ha-hae	pth
paite chin	pck
matal	mfh
bumaji	byp
haida	hdn
northern toussian	tsp
djinba	djb
quiavicuzas zapotec	zpj
asho chin	csh
ghulfan	ghl
batui	zbt
wageman	waq
asue awyu	psa
mombum	mso
kobon	kpw
vunapu	vnp
zazaki	kiu
lamma	lev
iwaidja	ibd
cayuga	cay
kagoma	kdm
mabaan	mfz
upper grand valley dani	dna
merey	meq
tandroy-mahafaly malagasy	tdx
thai song	soa
sawi	saw
mountain koiali	kpx
san dionisio del mar huave	hve
kirikiri	kiy
puragi	pru
logba	lgq
filipino	fil
adnyamathanha	adt
tamashek	tmh
banjar	bjn
aka-jeru	akj
tsimihety malagasy	xmw
chaozhou	nan
west makian	mqs
abaga	abg
dugun	ndu
habu	hbu
shua	shg
kera	ker
woccon	xwc
ponosakan	pns
kuku-uwanh	uwa
izere	izr
tukumanfed	tkf
binahari	bxz
dacian	xdc
yanahuanca pasco quechua	qur
buginese	bug
bolondo	bzm
tayo	cks
wusi	wsi
southwestern bontok	vbk
parecis	pab
lopa	lop
malaccan creole malay	ccm
warduji	wrd
guarayu	gyr
ambonese malay	abs
seko tengah	sko
kilmeri	kih
taungyo	tco
boselewa	bwf
imbongu	imo
long phuri naga	lpn
lepontic	xlp
negerhollands	dcr
ntomba	nto
sanapana	spn
judeo-iraqi arabic	yhd
ngarigu	xni
nyeu	nyl
yahuna	ynu
hawai'i pidgin sign language	hps
oblo	obl
rien	rie
samre	sxm
french belgian sign language	sfb
koasati	cku
tartessian	txr
norwegian	nob
belhare	byw
middle korean	okm
akhvakh	akv
kpasam	pbn
highland totonac	tos
antekerrepenhe	aer
manya	mzj
gowlan	goj
nadeb	mbj
enya	gey
tumtum	tbr
zayse-zergulla	zay
sursurunga	sgz
yoke	yki
nusa laut	nul
gambian wolof	wof
dirari	dit
kyaka	kyc
sinicahua mixtec	xti
urhobo	urh
toqabaqita	mlu
ligenza	lgz
odut	oda
najdi arabic	ars
north central mixe	neq
mamusi	kdf
tagalog	tgl
konomala	koa
izon	ijc
taworta	tbp
yabong	ybo
kaptiau	kbi
cumbric	xcb
bungku	bkz
hewa	ham
patpatar	gfk
karranga	xrq
nimadi	noe
central kurdish	ckb
mycenaean greek	gmy
kaurna	zku
edwas	bnv
loyop	urr
dedua	ded
kochila tharu	thq
arrarnta	are
aluo	yna
esuma	esm
bunak	bfn
sarudu	sdu
labuk-kinabatangan kadazan	dtb
jorto	jrt
laghu	lgb
huaxcaleca nahuatl	nhq
gan chinese	gan
auyokawa	auo
toromono	tno
kulere	kul
caka	ckx
seti	sbi
shatt	shj
fagauvea	uve
anor	anj
southern puget sound salish	slh
tachawit	shy
kanoe	kxo
qashqa'i	qxq
cakfem-mushere	cky
hibito	hib
babatana	baa
byep	mkk
kalanadi	wkl
pacahuara	pcp
muruwari	zmu
malyangapa	yga
tajio	tdj
guwa	xgw
dekwana	mch
andi	ani
danish	dan
pwaamei	pme
palantla chinantec	cpa
yangum dey	yde
old persian	peo
chichonyi-chidzihana-chikauma	coh
bulo stieng	sti
nakara	nck
cook islands maori	rar
kraho	xra
south ucayali asheninka	cpy
jordanian sign language	jos
keninjal	knl
yana	ynn
miani	pla
gourmanchema	gux
manusela	wha
wik-epa	wie
nung	nut
pear	pcb
turumsa	tqm
nyambo	now
sranan tongo	srn
barzani jewish neo-aramaic	bjf
mapun	sur
chalcatongo mixtec	mig
mwan	moa
ponam	ncc
tutuba	tmi
bila	bip
lobi	lob
minoan	omn
isconahua	isc
jahanka	jad
pech	pay
moyadan itneg	ity
pokanga	pok
shuar	jiv
ma'anyan	mhy
orok	oaa
gumatj	gnn
carolinian	cal
khazar	zkz
blissymbolics	zbl
ocotepec zapotec	ztu
bukar-sadung bidayuh	sdo
wadiyara koli	kxp
toposa	toq
mawayana	mzx
northwest oaxaca mixtec	mxa
mator	mtm
western tamang	tdg
northern binukidnon	kyn
nyanja	nya
cori	cry
purum	pub
ibu	ibu
yawa	yva
'auhelawa	kud
kompane	kvp
kwanja	knp
northern roglai	rog
koti	eko
piti	pcn
kapauri	khp
southern nisu	nsd
gresi	grs
dusun malang	duq
mam	mam
shihhi arabic	ssh
northern kurdish	kmr
adi	adi
ormuri	oru
maharastri prakrit	pmh
waxianghua	wxa
nyokon	nvo
aghem	agq
lukpa	dop
mamvu	mdi
suabo	szp
fanamaket	bjp
tiranige diga dogon	tde
arrernte	aer
kiliwa	klb
asuri	asr
sabaot	spy
waura	wau
chara	cra
awyi	auw
cisalpine gaulish	xcg
mubi	mub
angika	anp
to'aba'ita	mlu
rungwa	rnw
komi	koi
sacapulteco	quv
avaric	ava
persian	pes
yerakai	yra
dadibi	mps
western parbate kham	kjl
asheninka perene	prq
livvi	olo
domaaki	dmk
galician	glg
tala	tak
iraqw	irk
fyer	fie
bwanabwana	tte
suau	swp
cuiba	cui
bantawa	bap
yulu	yul
shambala	ksb
sharwa	swq
hmong	blu
washo	was
old manipuri	omp
kaimbulawa	zka
awutu	afu
supyire	spp
guerrero amuzgo	amu
ga'anda	gqa
babalia creole arabic	bbz
kuskokwim	kuu
kalaktang monpa	kkf
chang naga	nbc
ngunawal	xul
natugu	ntu
yuru	ljx
unggaranggu	xun
namuyi	nmy
nara	nrb
ewondo	ewo
ghanongga	ghn
ngas	anc
uneme	une
enxet	enx
teke-tege	teg
alanic	xln
musak	mmq
alago	ala
gboloo grebo	gec
turkish sign language	tsm
malaccan creole portuguese	mcm
palya bareli	bpx
polonombauk	plb
sensi	sni
intha	int
punthamara	xpt
spanish	spa
seri	sei
gejia	hmj
peripheral mongolian	mvf
tarok	yer
ramoaaina	rai
matengo	mgv
teshenawa	twc
wiarumus	tua
central sierra miwok	csm
nonuya	noj
t'en	tct
berta	wti
yanyuwa	jao
chayuco mixtec	mih
jwira-pepesa	jwi
western tunebo	tnb
wadjigu	wdu
siliput	mkc
kambaata	ktb
southern ngbandi	nbw
uzbek	uzb
french sign language	fsl
ampanang	apg
morelos nahuatl	nhm
yucuna	ycn
russian + english	eng
southern alta	agy
nyakyusa-ngonde	nyy
eastern mnong	mng
quiotepec chinantec	chq
central bontok	lbk
bayot	bda
tegali	ras
suena	sue
bunaba	bck
ekegusii	guz
sedang	sed
nakame	nib
kitharaka	thk
pu ko	puk
old saxon	osx
northern rengma naga	nnl
paunaka	pnk
balangao	blw
torwali	trw
international sign	ils
kirdki	zza
maxi gbe	mxl
buamu	box
sangtam naga	nsa
chaudangsi	cdn
mushungulu	xma
mattoki	xnz
danish + norwegian	nob
faire atta	azt
dizin	mdx
edolo	etr
xinca	xin
iowa-oto	iow
vilela	vil
aja	ajg
dagara	dgi
paulohi	plh
san francisco matlatzinca	mat
bakumpai	bkr
mbangwe	zmn
muslim tat	ttt
gupapuyngu	guf
middle newar	nwx
sukuma	suk
waskia	wsk
nobonob	gaw
khvarshi	khv
lufu	ldq
selian	sxl
zuni	zun
huaulu	hud
=/hua	huc
yafi	wfg
taiwanese	nan
panao huanuco quechua	qxh
sharanahua	mcd
toma	tod
khezha naga	nkh
maku	yab
kakabai	kqf
mawan	mcz
cora	crn
pancana	pnp
ngurimi	ngq
zanaki	zak
batak mandailing	btm
kuijau	dkr
sakao	sku
primitive irish	pgl
pacaraos quechua	qvp
abadi	kbt
jungle inga	inj
gergiko	moz
dhivehi	div
north awyu	yir
breton	bre
santa catarina albarradas zapotec	ztn
rejang kayan	ree
western frisian	fry
yocoboue dida	gud
rawa	rwo
we northern	wob
spiti bhoti	spt
walla walla	waa
aiome	aki
nanga dama dogon	nzz
kabwa	cwa
karore	xkx
bilaspuri	kfs
maxakali	mbl
arakwal	rkw
naki	mff
minriq	mnq
ndebele	nde
waddar	wbq
surubu	sde
bhasa	new
kato	ktw
rama	rma
judeo-spanish	lad
tae'	rob
nimo	niw
dengka	dnk
tinigua	tit
western xwla gbe	xwl
arabana	ard
nema	gsn
kplang	kph
dhimal	dhi
basay	byq
swampy cree	csw
dungmali	raa
logo	log
gangte	gnb
bazigar	bfr
mariri	mqi
adiwasi garasia	gas
colorado	cof
gbii	ggb
borgu fulfulde	fue
bamunka	bvm
dao	daz
rakahanga-manihiki	rkh
toro	tdv
maleu-kilenge	mgl
andoa	anb
liabuku	lix
bilin	byn
bambili-bambui	baw
mararit	mgb
hmong njua	blu
inuinnaqtun	ikt
czech sign language	cse
padoe	pdo
kumalu	ksl
kokata	ktd
khuen	khf
coos	csz
baelelea	bvc
trinidadian creole english	trf
tewe	twx
blissymbols	zbl
tanaina	tfn
northern huishui hmong	hmi
turkish	tur
west central banda	bbp
mullukmulluk	mpb
sudanese arabic	apd
lulogooli	rag
chitwania tharu	the
geba karen	kvq
giyug	giy
kipsigis	sgc
oluluyia	luy
centuum	cet
semnani	smy
urdu	urd
nimbari	nmr
aura	aux
marik	dad
yakan	yka
transalpine gaulish	xtg
sira	swj
matagalpa	mtn
sinte romani	rmo
tita	tdq
finnish sign language	fse
sakha	sah
media lengua	mue
suomenruotsalainen viittomakieli	fss
waja	wja
badi kanum	khd
brazilian sign language	bzs
ladin	lld
waigali	wbk
zabana	kji
obulom	obu
puma	pum
askopan	eiv
kairui-midiki	krd
satawalese	stw
dumi	dus
komi-permyak	koi
nelemwa-nixumwak	nee
moldavian	ron
libyan arabic	ayl
huichol	hch
embera-tado	tdc
laari	ldi
kota marudu talantang	grm
parauk	prk
maranao	mrw
krevinian	zkv
yopno	yut
bile	bil
dawawa	dww
southwestern tarahumara	twr
vai	vai
horom	hoe
xipaya	xiy
vame	mlr
kete	kcv
seediq	trv
pumi	pmi
rangkas	rgk
nkami	nkq
melo	mfx
gungabula	gyf
tenango otomi	otn
pai tavytera	pta
sengele	szg
lhomi	lhm
tillamook	til
tapirape	taf
deori	der
mro-khimi chin	cmr
moraid	msg
soyaltepec mixtec	vmq
kwanyama	kua
northern embera	emp
central pomo	poo
klao	klu
southern grebo	grj
chinese sign language	csl
saho	ssy
minaveha	mvn
chepang	cdm
lala-roba	lla
andra-hus	anx
bimin	bhl
tuwali ifugao	ifk
nhanda	nha
mbum	mdd
veneto	vec
biyo	byo
angoram	aog
harzani	hrz
pije	piz
modole	mqo
enu	enu
kanamari	knm
oscan	osc
oro win	orw
lukabaras	lkb
mongondow	mog
nkari	nkz
tangko	tkx
indonesian sign language	inl
sui	swi
lish	lsh
pirlatapa	bxi
bashkir	bak
guwinmal	xgm
tombonuo	txa
haigwai	hgw
daw	kwa
khowar	khw
southern guiyang hmong	hmy
barein	bva
kham	kjl
maindo	cwb
mouk-aria	mwh
epie	epi
loko	lok
mingang doso	mko
arta	atz
jumjum	jum
yongkom	yon
moksha	mdf
bororo	bor
southern kisi	kss
southern nuni	nnw
arho	aok
batak alas-kluet	btz
aimol	aim
gilyak	niv
geman deng	mxj
amurdak	amg
budeh stieng	stt
queyu	qvy
kinamiging manobo	mkx
zande	zne
jaya	jyy
ipiko	ipo
aimele	ail
arifama-miniafia	aai
mesmes	mys
kayan mahakam	xay
djawi	djw
saotomense	cri
waima	rro
kirghiz	kir
truka	tka
tonsawang	tnw
beezen	bnz
wajarri	wbv
tetun	tdt
litzlitz	lzl
sanuma	xsu
aka-kora	ack
upper kuskokwim	kuu
ndolo	ndl
palor	fap
miji	sjl
bonerate	bna
pini	pii
cameroon pidgin	wes
mauritian sign language	lsy
san martin itunyoso triqui	trq
walser	wae
cochimi	coj
sie	erg
kamu	xmu
xerente	xer
erzya	myv
mlap	kja
mysian	yms
totonac	tlp
luguru	ruf
coatlan zapotec	zps
ho	hoc
jangkang	djo
zacatlan-ahuacatlan-tepetzintla nahuatl	nhi
tukang besi	bhq
sekak	lce
ukwa	ukq
mehek	nux
abipon	axb
northern tepehuan	ntp
amara	aie
kanuri	kau
lambayeque quechua	quf
mwera	mwe
bondei	bou
wirangu	wgu
northern kalapuya	nrt
moru	mgd
venda	ven
classical newari	nwc
okodia	okd
dzuungoo	dnn
yessan-mayo	yss
hopi	hop
diuxi-tilantongo mixtec	xtd
western neo-aramaic	amw
western bukidnon manobo	mbb
krache	kye
kriol	rop
kaytetye	gbb
tanapag	tpv
tsat	huq
sichuan yi	iii
kitja	gia
tlingit	tli
tommo so dogon	dto
yaul	yla
boruca	brn
maleng	pkt
buhutu	bxh
central nahuatl	nhn
haitian vodoun culture language	hvc
shasta	sht
adygei	ady
inoke-yate	ino
umiida	xud
ben tey dogon	dbt
murrinh-patha	mwf
yabula yabula	yxy
maku'a	lva
pemono	pev
akurio	ako
aklanon	akl
kwinti	kww
lower southern aranda	axl
eastern pwo	kjp
aikana	tba
sardinian	src
majhi	mjz
sedoa	tvw
bora	boa
kanembu	kbl
gbagyi	gbr
yawanawa	ywn
santa maria zacatepec mixtec	mza
sesotho	sot
buriat	bua
hun-saare	dud
chiapanec	cip
seberuang	sbx
orang kanaq	orn
lanas lobu	ruu
kanauji	bjj
gofa	gof
mato	met
tai don	twh
koenoem	kcs
mapidian	mpw
kuan	uan
aer	aeq
han	haa
sos kundi	sdk
tolaki	lbw
western balochi	bgn
tai yo	tyj
gepo	ygp
gundungurra	xrd
kepkiriwat	kpn
gail	gic
northwest pashai	glh
hitu	htu
lenkau	ler
jina	jia
cowlitz	cow
donno so dogon	dds
old tamil	oty
tlacoapa me'phaa	tpl
tora	trz
hlepho phowa	yhl
lere	gnh
tamajaq	ttq
manga kanuri	kby
ofo	ofo
woods cree	cwd
mankanya	knf
tay sa pa	tys
kwami	ktf
aranadan	aaf
tutong	ttg
ketum	ktt
sakachep	sch
tha	thy
guntai	gnt
duri	mvp
vitu	wiv
giiwo	kks
illyrian	xil
yawuru	ywr
bwatoo	bwa
supyire senoufo	spp
amaimon	ali
martha's vineyard sign language	mre
balanta-kentohe	ble
edera awyu	awy
uruguayan sign language	ugy
jewish palestinian aramaic	jpa
northern guiyang hmong	huj
qabiao	laq
rarotongan	rar
bemba	bem
bafanji	bfj
basa-gurmana	buj
patep	ptp
lomavren	rmi
north mesopotamian arabic	ayp
swedish sign language	swl
agi	aif
marimanindji	zmm
busam	bxs
karankawa	zkk
abron	abr
nakwi	nax
burmbar	vrt
shoo-minda-nye	bcv
norse	non
kiembu	ebu
abellen ayta	abp
gunditjmara	gjm
western keres	kjq
olusamia	lsm
hutterisch	geh
luyia	luy
magdalena penasco mixtec	xtm
mehri	gdq
vlax romani	rmy
koy sanjaq surat	kqd
middle hittite	htx
yugambal	yub
liburnian	xli
mediak	mwx
serili	sve
georgisch	kat
akolet	akt
church slavic	chu
ahom	aho
olekha	ole
yuki	yuk
tolowa	tol
lianshan zhuang	zln
vagla	vag
settla	sta
chitkuli kinnauri	cik
malawi lomwe	lon
kamba	kam
odia	ory
martu wangka	mpj
karkin	krb
catawba	chc
semelai	sza
goan konkani	gom
sehwi	sfw
manyika	mxc
gaelic	gla
lijili	mgi
kuria	kuj
bitare	brt
baniva	bvv
lower tanana	taa
boguru	bqu
kwamtim one	okk
tonga	toi
yoba	yob
maldivian	div
pimbwe	piw
talinga-bwisi	tlj
shwe palaung	pll
bhaya	bhe
anguthimri	aid
wutung	wut
waruna	wrv
mbula-bwazza	mbu
rembong	reb
lango	laj
kombai	tyn
ndzwani comorian	wni
ancient aramaic	oar
shekhawati	swv
mobilian	mod
makalero	mjb
puinave	pui
guahibo	guh
arabic	arb
kudu-camo	kov
ruching palaung	pce
karaim	kdr
pa'o	blk
burmeso	bzu
kodia	kwp
kyerung	kgy
upper saxon	sxu
idesa	ids
minanibai	mcv
kalispel-pend d'oreille	fla
nias	nia
kajaman	kag
yintale karen	kvy
siraya	fos
barama	bbg
nambikuara	nab
dhudhuroa	ddr
kolami	kfb
khandesi	khn
belhariya	byw
seki	syi
efutop	ofu
sorothaptic	sxo
macedo-romanian	rup
asoa	asv
dahalo	dal
uyajitaya	duk
demisa	dei
fa d'ambu	fab
yout wam	ytw
bagri	bgq
eastern abnaki	aaq
chhintange	ctn
jamaican sign language	jls
santiago del estero quichua	qus
uncoded languages	mis
waffa	waj
ambala ayta	abc
middle dutch	dum
southern kalapuya	sxk
twana	twa
aruek	aur
barok	bjk
ararandewara	xaj
didinga	did
arha	aqr
oriya	ori
sheni	scv
jju	kaj
northwest maidu	mjd
mwerlap	mrm
pangwa	pbr
chepya	ycp
notsi	ncf
kerewo	kxz
kyanga	tye
bambalang	bmo
huambisa	hub
lewotobi	lwt
abu	ado
manichaean middle persian	xmn
arutani	atx
tuscarora	tus
dusner	dsn
yagnobi	yai
central subanen	syb
fiji hindi	hif
tunen	tvu
wik-keyangan	wif
remontado dumagat	agv
taikat	aos
tanahmerah	tcm
ngamini	nmv
budza	bja
!xoo	nmn
bankon	abb
ibuoro	ibr
southern sama	ssb
vincentian creole english	svc
tai long	thi
gogo	gog
argentine sign language	aed
mambae	mgm
petjo	pey
chachi	cbi
sekele	vaj
yakoma	yky
palikur	plu
eskayan	esy
omi	omi
javanese	jav
burate	bti
nukuini	nuc
suba-simbiti	ssc
kalami	gwc
bolongan	blj
cajamarca quechua	qvc
mukha-dora	mmk
dhivehi maldivian	div
toda	tcx
mayogo	mdm
ngaanyatjarra	ntj
jaqaru	jqr
lithuanian	lit
purari	iar
gundi	gdi
poyanawa	pyn
tay tac	tyt
skalvian	svx
western abnaki	abe
bughotu	bgt
navaho	nav
ume sami	sju
chinese pidgin english	cpi
lengua de senas catalana	csc
gaddang	gad
umbrian	xum
budukh	bdk
gaviao	gvp
adangbe	adq
fayu	fau
piame	pin
ghayavi	bmk
bahonsuai	bsu
malua bay	mll
jangshung	jna
ancient greek	grc
kuanua	ksd
nawathinehena	nwa
gobasi	goi
kehu	khh
baltic romani	rml
columbia-wenatchi	col
car nicobarese	caq
long wat	ttw
beami	beo
lemnian	xle
dem	dem
parachi	prc
biao	byk
zakhring	zkr
onobasulu	onn
ndengereko	ndg
yela	yel
fuliiru	flr
saek	skb
rusyn	rue
dehwari	deh
mag-antsi ayta	sgb
banggai	bgz
texmelucan zapotec	zpz
chayahuita	cbt
lule sami	smj
malinaltepec tlapanec	tcf
gangulu	gnl
yoruba	yor
musasa	smm
kinuku	kkd
san dionicio ocotepec zapotec	ztu
mendalam kayan	xkd
mai brat	ayz
koko babangk	okg
western muria	mut
yaroame	yro
nake	nbk
beba	bfp
narau	nxu
kemberano	bzp
solano	xso
mbelime	mql
phalura	phl
sinaugoro	snc
dungu	dbv
wogamusin	wog
old basque	???
wagaya	wga
puare	pux
iyo'wujwa chorote	crq
ao naga	njo
chuka	cuh
takia	tbc
middle english	enm
savi	sdg
javindo	jvd
wardaman	wrr
dumbea	duf
idi	idi
wanyi	gbc
igana	igg
tankarana malagasy	xmv
lamogai	lmg
kichaga	jmc
jamaican creole english	jam
touo	tqu
yitha yitha	xth
bayungu	bxj
lembena	leq
afitti	aft
iraya	iry
ten'edn	tnz
bintauna	bne
urim	uri
benggoi	bgy
bomwali	bmw
airoran	air
apasco-apoala mixtec	mip
ngungwel	ngz
asheninca campa	cpu
yuyu	yxu
machinere	mpd
cree	crk
welsh romani	rmw
cupeno	cup
kuri	nbn
tomo kan dogon	dtm
montagnais	moe
sivandi	siy
katawixi	xat
ebughu	ebg
jamaican	jam
ixil	ixi
bindal	xbd
playero	gob
bambara	bam
tumbuka	tum
leyigha	ayi
temein	teq
furu	fuu
nzakara	nzk
southern nago	nqg
tima	tms
guiqiong	gqi
buyu	byi
kwaio	kwd
sierra negra nahuatl	nsu
malaryan	mjq
barambu	brm
dutch sign language	dse
sasak	sas
baiso	bsw
zyphe chin	zyp
chicahuaxtla triqui	trs
limburger	lim
tause	tad
baga pokur	bcg
yautepec zapotec	zpb
lomaiviti	lmv
mongolian	khk
horned miao	hrm
guanyinqiao	jiq
marangis	wax
temiar	tea
isthmus-pajapan nahuatl	nhp
tanguat	tbs
buhi'non bikol	ubl
oy	oyb
kati	bsh
thudam	thw
chinesischen	cmn
atakapa	aqp
ayere	aye
luwo	lwo
sansi	ssi
a'tong	aot
suoy	syo
dawera-daweloor	ddw
kim mun	mji
hinduri	hii
paku karen	jkp
central huasteca nahuatl	nch
gengle	geg
kominimung	xoi
maskelynes	klv
vinmavis	vnm
coatzospan mixtec	miz
bisis	bnw
usaghade	usk
sentinel	std
teke-tsaayi	tyi
marenje	vmr
tektiteko	ttc
hdi	xed
khasi	kha
chilisso	clh
herde	hed
ngongo	noq
imbabura quechua	qvi
western highland chatino	ctp
khorasani turkish	kmz
aighon	aix
gawar-bati	gwt
loo	ldo
deg	mzw
kopkaka	opk
moseten	cas
daantanai'	lni
hya	hya
classical quechua	qwc
qila muji	ymq
kwini	gww
southwest pashai	psh
atatlahuca mixtec	mib
njebi	nzb
gujarati	guj
tilquiapan zapotec	zts
seeku	sos
phukha	phh
shan	shn
belarusian	bel
batak dairi	btd
tairora	tbg
japanese	jpn
palpa	plp
bende	bdp
arikapu	ark
abau	aau
mea	cir
galambu	glo
parkari koli	kvx
pentlatch	ptw
no linguistic content	zxx
traveller norwegian	rmg
kairak	ckr
bine	bon
tukang besi north	khc
gweda	grw
tanimuca-retuara	tnc
kanum	kcd
natanzi	ntz
far western muria	fmu
sambe	xab
mapuche	arn
umanakaina	gdn
bantik	bnq
northern nisu	yiv
saruga	sra
wichi lhamtes nocten	mtp
ambele	ael
alabat island agta	dul
tiri	cir
yamna	ymn
maghdi	gmd
erokwanas	erw
sartang	onp
yevanic	yej
izii	izz
kanakanabu	xnb
mokole	mkl
chuang	zha
saraveca	sar
sallands	sdz
ta'izzi-adeni arabic	acq
fipa	fip
miship	mjs
ravula	yea
lala	nrz
musom	msu
dido	ddo
shona	sna
meoswar	mvx
wakabunga	wwb
iku-gora-ankwa	ikv
isoko	iso
gunya	gyy
beng	nhb
mauritian	mfe
santa ana de tusi pasco quechua	qxt
karon dori	kgw
hmar	hmr
mango	mge
gagauz	gag
baoule	bci
jutish	jut
kacipo-balesi	koe
gogodala	ggw
moldovan	ron
ngeq	ngt
kalou	ywa
likum	lib
makwe	ymk
abun	kgr
babine	bcr
casuarina coast asmat	asc
aputai	apx
makuri naga	jmn
iranian	pes
brithenig	bzt
gorowa	gow
tsum	ttz
kenyi	lke
maya	itz
pashto	pbt
greek	ell
serer	srr
eastern tawbuid	bnj
phuong	phg
brahui	brh
oune	oue
perai	wet
twents	twd
kis	kis
parsi	prp
san francisco del mar huave	hue
old lithuanian	???
central-eastern niger fulfulde	fuq
ona	ona
kaivi	kce
tajik	tgk
chimborazo highland quichua	qug
ocaina	oca
north junin quechua	qvn
bunoge dogon	dgb
koorete	kqy
carib	car
otank	uta
jarai	jra
central aymara	ayr
kaluli	bco
i'saka	ksi
ottawa	otw
telugu	tel
eyak	eya
tausug	tsg
samaritan	smp
svan	sva
dom	doa
ngandyera	nne
mirgan	zrg
karamojong	kdj
betaf	bfe
foma	fom
shempire senoufo	seb
sara kaba deme	kwg
mur pano	tkv
desano	des
eastern meohang	emg
mulam	mlm
west greenlandic	kal
marau	mvr
mahasu pahari	bfz
newari	new
diuwe	diy
ntcham	bud
rathwi bareli	bgd
laiyolo	lji
ndyuka-trio pidgin	njt
lalia	lal
lyons sign language	lsg
huilliche	huh
classical syriac	syc
ndombe	ndq
pochuri naga	npo
karitiana	ktn
sarsi	srs
bangala	bxg
rombo	rof
dhungaloo	dhx
saraiki	skr
moba	mfq
ǂungkue	gku
tal	tal
tok pisin	tpi
ban khor sign language	bfk
baluchi	bal
korlai creole portuguese	vkp
saweru	swr
kaera	jka
northern haida	hdn
snohomish	sno
tehuelche	teh
magbukun ayta	ayt
blagar	beu
shwai	shw
chakma	ccp
judeo-berber	jbe
ikpeshi	ikp
gokana	gkn
western xiangxi miao	mmr
otuke	otu
gazi	gzi
phende	pem
temoq	tmo
meru	mer
siri	sir
barbacoas	bpb
motu	meu
ibanag	ibg
tawoyan	twy
kirya-konzəl	fkk
uya	usu
krongo	kgo
yangum mon	ymo
chhattisgarhi	hne
tanimbili	tbe
gitxsan	git
icelandic sign language	icl
legbo	agb
buru	mhs
hupla	hap
baga koga	bgo
jenaama bozo	bze
extremaduran	ext
yekhee	ets
moro	mor
mparntwe arrernte	aer
tuki	bag
tataltepec chatino	cta
written oirat	xwo
gobu	gox
lubukusu	bxk
provencal	pro
lelemi	lef
kalaamaya	lkm
gurgula	ggg
jamamadi	jaa
dama	dmm
dyaabugay	dyy
monastic sign language	mzg
port sandwich	psw
denya	anv
eskimo	kal
banda-mbres	bqk
indian sign language	ins
trumai	tpy
aiton	aio
nkem-nkum	isi
south efate	erk
norwegian bokmal	nob
iyive	uiv
hehe	heh
mangerr	zme
kanufi	kni
bosngun	bqs
tuma-irumu	iou
chiru	cdf
molengue	bxc
sian	spg
campalagian	cml
marghi central	mrt
saluma	slj
bete-bendi	btt
yipma	byr
loxicha zapotec	ztp
labo phowa	ypb
tsotso	lto
orokolo	oro
migum	klm
creek	mus
tso	ldp
karata	kpt
bierebo	bnk
avikam	avi
cibak	ckl
diriku	diu
gone dau	goo
kunja	pep
haka chin	cnh
eastern oromo	hae
southern subanen	laa
kaian	kct
taznatit	grr
sherbro	bun
pume	yae
dii	dur
eastern bolivian guarani	gui
dawida	dav
indonesian bajau	bdl
macushi	mbc
boloki	bkt
fataluku	ddg
axi yi	yix
lahul lohar	lhl
northern qiang	cng
wapha	juw
copainala zoque	zoc
tupinikin	tpk
goodenough	ddi
akpes	ibe
xishanba lalo	ywt
bajan	bjs
tetelcingo nahuatl	nhg
kaningdon-nindem	kdp
peranakan indonesian	pea
movima	mzp
kabardian	kbd
dhargari	dhr
severn ojibwa	ojs
ngalakgan	nig
ngayawung	nwg
suri	suq
andarum	aod
western magar	mrd
degaru	dgu
thaypan	typ
buli	bwu
chemakum	xch
bor	bxb
eastern muria	emu
seit-kaitetu	hik
pankarare	pax
north slavey	scs
kandawo	gam
petalcingo tzeltal	tzb
lahta karen	kvt
harsusi	hss
narim	loh
minang	xrg
ata manobo	atd
manna-dora	mju
ralte	ral
nipsan	nps
mok	mqt
berbice creole dutch	brc
eastern magar	mgp
valman	van
san lucas quiavini	zab
chala	cll
tuwari	tww
akwa	akw
ushojo	ush
south bolivian quechua	quh
tindi	tin
uma' lung	ulu
kaure	bpp
thai sign language	tsq
efe	efe
cinda-regi-tiyal	cdr
makolkol	zmh
dampelas	dms
doka	dbi
tereno	ter
bosnian	srp
pamlico	pmk
akukem	spm
mara	mec
biao-jiao mien	bje
bidhawal	ihw
central ojibwa	ojc
badimaya	bia
huallaga huanuco quechua	qub
quiripi	qyp
wakde	wkd
guruntum-mbaaru	grd
eastern huishui hmong	hme
waiwai	waw
kagulu	kki
sylheti	syl
wuding-luquan yi	ywq
wipi	gdr
riverain sango	snj
kinabalian	cbw
lower silesian	sli
thiin	iin
ndo	ndp
badyara	pbp
songo	soo
chamicuro	ccc
wayampi	oym
zenzontepec chatino	czn
lamu-lamu	lby
narua	nru
guato	gta
nocaman	nom
culina	cul
jambi malay	jax
mwatebu	mwa
northern tutchone	ttm
west coast bajau	bdr
lungalunga	vmg
mbukushu	mhw
san juan atzingo popoloca	poe
badeshi	bdz
dwang	nnu
opata	opt
sawknah	swn
rongga	ror
nnam	nbp
urningangg	urc
hawai'i pidgin	hwc
yambeta	yat
mpalitjanh	xpj
kohumono	bcs
trimuris	tip
naskapi	nsk
brunei	kxd
tsakhur	tkr
western panjabi	pnb
eastern bontok	ebk
pipil	ppl
shuswap	shs
jadgali	jdg
eastern parbate kham	kif
laz	lzz
tampias lobu	low
tiruray	tiy
drents	drt
beeke	bkf
topoiyo	toy
rempi	rmp
loja highland quichua	qvj
aduge	adu
shi	shr
moni	mnz
balantak	blz
fur	fvr
minokok	mqq
tolomako	tlm
zapotec	zap
capanahua	kaq
kwinsu	kuc
zulu	zul
numee	kdk
abon	abo
kairiru	kxa
malimpung	mli
coastal konjo	kjc
kusaghe	ksg
//ani	hnh
south central dinka	dib
lutos	ndy
sera	sry
hmong don	hmf
beothuk	bue
savosavo	svs
cusco quechua	quz
xwela gbe	xwe
ninzo	nin
southern aymara	ayc
inlaod itneg	iti
kwesten	kwt
eastern cham	cjm
karang	kzr
anjam	boj
tagakaulo	klg
yoloxochitl mixtec	xty
chittagonian	ctg
soqotri	sqt
gumawana	gvs
ndonga	ndo
mayi-kulan	xyk
bezhta	kap
ekari	ekg
east damar	dmr
mmen	bfm
naha'ai	mlx
manange	nmm
mangue	mom
mwotlap	mlv
tsaukambo	kvz
lower burdekin	xbb
aka-bea	abj
bamu	bcf
kadar	kej
polnisch	pol
literary chinese	lzh
biangai	big
north tairora	tbg
tasmanian	xtz
himarima	hir
bisu	bzi
sami	sme
kholok	ktc
nukuria	nur
tol	jic
tamki	tax
langam	lnm
bankal	jjr
djadjawurrung	dja
kawaiisu	xaw
kunjen	kjn
ancient zapotec	xzp
mitla zapotec	zaw
ukaan	kcf
tainae	ago
southern rengma naga	nre
narango	nrg
luiseno	lui
american sign language	ase
emae	mmw
urum	uum
kakabe	kke
idon	idc
kumba	ksm
yagomi	ygm
lishanid noshan	aij
gronings	gos
sula	szn
maltese	mlt
classical nepal bhasa	nwc
guwamu	gwu
tsez	ddo
bomboli	bml
wichi lhamtes vejoz	wlv
michif	crg
romagnol	rgn
keoru-ahia	xeu
south african sign language	sfs
dhatki	mki
bu	jid
lilau	lll
macuiltianguis zapotec	zaa
dai	khb
samoan	smo
telefol	tlf
imroing	imr
kokoda	xod
old provencal	pro
tahitian	tah
tiang	tbj
pangwali	pgg
beaver	bea
nambo	ncm
central kanuri	knc
alu kurumba	xua
buduma	bdm
rengao	ren
nomlaki	nol
nahari	nhh
tengger	tes
bonggi	bdg
mapudungun	arn
sindihui mixtec	xts
adai	xad
odual	odu
ossetian	oss
mbandja	zmz
hunjara-kaina ke	hkk
bavarian	bar
nduga	ndx
tieyaxo bozo	boz
bo-rukul	mae
c'lela	dri
salchuq	slq
owiniga	owi
bonggo	bpg
muyang	muy
akeu	aeu
biak	bhw
nsongo	nsx
geruma	gea
buol	blf
nyoro	nyo
budu	buu
puimei naga	npu
chiquian ancash quechua	qxa
limbu	lif
vamale	mkt
krikati-timbira	xri
disa	dsi
namosi-naitasiri-serua	bwb
nde-nsele-nta	ndd
talaandig	bkd
mekeo	mek
farefare	gur
temacine tamazight	tjo
lopit	lpx
onin based pidgin	onx
nukak maku	mbr
kalabari	ijn
atsam	cch
sissano	sso
koyra chiini songhay	khq
chuvash	chv
sekapan	skp
louisiana creole	lou
helong	heg
kaur	vkk
nanerige senoufo	sen
sanggau	scg
banda malay	bpq
boikin	bzf
chukchi	ckt
nanticoke	nnt
lave	brb
ocotlan zapotec	zac
lisu	lis
bare	bae
gbe	ewe
konni	kma
red gelao	gir
morori	mok
pangseng	pgs
malavedan	mjr
marwari	rwr
akaselem	aks
neku	nek
cajatambo north lima quechua	qvl
a-pucikwar	apq
walrpiri	wbp
sere	swf
pakistan sign language	pks
maquiritari	mch
hovongan	hov
greek sign language	gss
isinai	inn
ringgou	rgu
onondaga	ono
jamaican creole	jam
balangingi	sse
susuami	ssu
bugun	bgg
kalaallisut	kal
huli	hui
nimi	nis
kais	kzm
idakho-isukha-tiriki	ida
dhodia	dho
yamana	yag
mawukakan	mxx
barai	bbb
miskitu	miq
golpa	lja
vitou	vto
lhokpu	lhp
phuma	ypm
passamaquoddy	pqm
great andamanese	gac
seraiki	skr
standard latvian	lvs
celtiberian	xce
kuwaa	blh
lorediakarkar	lnn
galela	gbi
dicamay agta	duy
middle french	frm
bandial	bqj
tunzu	dza
slavonic	chu
ubi	ubi
nicaraguan sign language	ncs
arawak	arw
shau	sqh
koyaga	kga
kamano	kbq
kalanga	kck
smarky kanum	kxq
lumun	lmd
wanap	wnp
aguna	aug
aequian	xae
rema	bow
segeju	seg
wagdi	wbr
mandara	tbf
nyanga	nyj
siberian tatar	sty
dezfuli	def
mixtepec zapotec	zpm
hulung	huk
abui	abz
daasanach	dsh
ghadames	gha
anus	auq
tanosy malagasy	txy
tupinamba	tpn
usku	ulf
kven finnish	fkv
sierra leone sign language	sgx
north russian	rus
k'ichee'	quc
ozumacin chinantec	chz
kovai	kqb
chhulung	cur
nambya	nmq
hwana	hwo
manangkari	znk
doko-uyanga	uya
simeulue	smr
qawasqar	alc
bubi	buw
cishingini	asg
kamas	xas
western dani	dnw
kaamba	xku
siculo arabic	sqr
mlomp	mlo
jita	jit
guyani	gvy
jah hut	jah
lakkia	lbc
rerep	pgk
poumei naga	pmx
libido	liq
ngan'gityemerri	nam
ngemba	nge
rungtu chin	rtc
nend	anh
mekwei	msf
avestan	ave
keak	keh
polci	plj
barwe	bwg
vunjo	vun
sumbawa	smw
sur	tdl
kuku-mu'inh	xmp
northern nuni	nuv
dhofari arabic	adf
bateri	btv
njyem	njy
mengen	mee
hidatsa	hid
cruzeno	crz
woi	wbw
safeyoka	apz
gupa-abawa	gpa
min zhong chinese	czo
hiw	hiw
kopar	xop
mangarayi	mpc
aruamu	msy
domari	rmt
tongan	ton
makhuwa-shirima	vmk
//gana	gnk
noon	snf
kla-dan	lda
damal	uhn
barbaram	vmb
swiss-german sign language	sgg
som	smc
kapriman	dju
margany	zmc
alapmunte	apv
yidiny	yii
phake	phk
malagasy	plt
saterfriesisch	stq
nyangbo	nyb
gonja	gjn
tobagonian creole english	tgh
gabri	gab
northern amami-oshima	ryn
kreye	xre
woleaian	woe
ponyo-gongwang naga	npg
talossan	tzl
yucatec mayan	yua
mufian	aoj
batak angkola	akb
zulgo-gemzek	gnd
ladino	lad
maraghei	vmh
nomatsiguenga	not
sabane	sae
amarakaeri	amr
hawai'i sign language	hps
ere	twp
badui	bac
punan merap	puc
como karim	cfg
dijim-bwilim	cfa
surjapuri	sjp
scottish	trl
kudmali	kyw
armazic	xrm
mboi	moi
asumboa	aua
khumi chin	cnk
pallanganmiddang	pmd
kauwera	xau
nomu	noh
anmatyerre	amx
ukpe-bayobiri	ukp
bukitan	bkn
kouya	kyf
kwenyi	kdk
arosi	aia
puelche	pue
mendankwe-nkwen	mfd
southwestern nisu	nsv
kunza	kuz
bokobaru	bus
logorik	liu
mal paharia	mkb
namibian sign language	nbs
czech	ces
dyugun	dyd
petats	pex
bassossi	bsi
tiwi	tiw
kaonde	kqn
pinji	pic
yace	ekr
manumanaw karen	kxf
central sama	sml
kajakse	ckq
binandere	bhg
chambeali	cdh
sapo	krn
maia	sks
fedan	pdn
amatlan zapotec	zpo
oti	oti
alemannic	gsw
ekajuk	eka
kpatili	kym
kagan kalagan	kll
kate	kmg
sudest	tgo
tejalapan zapotec	ztt
lame	bma
karingani	kgn
hong kong sign language	hks
tombulu	tom
muzi	ymz
tewa	tew
tene kan dogon	dtk
kaibobo	kzb
birrpayi	xbj
khiamniungan naga	kix
eastern arrernte	aer
upper tanana	tau
limos kalinga	kmk
cantonese	yue
tehit	kps
talieng	tdf
sinasina	sst
tlacoapa tlapanec	tpl
yiddish	ydd
terebu	trb
azhe	yiz
subtiaba	sut
upper umpqua	xup
central pashto	pst
moronene	mqn
kabiye	kbp
vedic	san
yarsun	yrs
esimbi	ags
apalai	apy
nogai	nog
marsian	ims
gavar	gou
wanggamala	wnm
midob	mei
lingala	lin
chinook jargon	chn
nyong	muo
south picene	spx
gayil	gyl
sogdian	sog
mungbam	mij
costa rican sign language	csr
yukuben	ybl
tanzanian sign language	tza
neapolitan	nap
guya	gka
pahlavi	pal
halang doan	hld
san marcos tlacoyalco popoloca	pls
kofei	kpi
kumhali	kra
mo	wkd
gowli	gok
winye	kst
mandaya	mry
cia-cia	cia
songoora	sod
wotu	wtw
ningye	nns
tabaru	tby
fe'fe'	fmp
samogitian	sgs
wumbvu	wum
tsakonian	tsd
kissi	kqs
anii	blo
dimili	zza
vengo	bav
myene	mye
middle mongolian	xng
armenian	hye
rawo	rwa
patani	ptn
bongili	bui
ouma	oum
kalabakan	kve
pele-ata	ata
konabere	bbo
northern mashan hmong	hmp
asturleonese	ast
yecuatla totonac	tlc
kurukh	kru
gorap	goq
kubu	kvb
pinyin	pny
southern bontok	obk
old georgian	oge
siriono	srq
ter sami	sjt
punan tubu	puj
gabi-gabi	gbw
bafia	ksf
arem	aem
nigerian sign language	nsi
yirrk-mel	yrm
songlai chin	csj
urigina	urg
busa	bqp
amis	ami
hanunoo	hnn
northern khmer	kxm
aushi	auh
gorovu	grq
georgian	kat
tornedalen finnish	fit
loreto-ucayali spanish	spq
bofi	bff
quiegolani zapotec	zpi
kwangali	kwn
na-meo	neo
ndaka	ndk
komi-zyrian	kpv
nggem	nbq
tapei	afp
luopohe miao	hml
cotoname	xcn
nisa	njs
zoroastrian dari	gbz
kiong	kkm
drung	duu
gamit	gbl
cung	cug
ngulu	ngp
romam	rmx
texcatepec otomi	otx
prasuni	prn
dabe	dbe
emerillon	eme
suwawa	swu
mukulu	moz
tboli	tbl
gwere	gwr
larike-wakasihu	alo
lakon	lkn
kodeoha	vko
lealao chinantec	cle
dakota	dak
puyo-paekche	xpp
bwile	bwc
chuwabu	chw
laragia	lrg
dholuo	luo
falam chin	cfm
bagusa	bqb
nyigina	nyh
tsuvan	tsh
san marcos tlalcoyalco popoloca	pls
rotokas	roo
toku-no-shima	tkn
judeo-persian	jpr
wiyot	wiy
northern bontok	rbk
ngawun	nxn
fwai	fwa
bolango	bld
luxembourgish	ltz
mlabri	mra
mussau-emira	emi
slavomolisano	svm
mingrelian	xmf
abureni	mgj
maritsaua	msp
abelam	abt
wanbasana	alw
kpati	koc
baniwa	bwi
ukhrul	nmf
raji	rji
mid grand valley dani	dnt
dulong	duu
kuthant	xut
ot danum	otd
boor	bvf
north tanna	tnn
yom	pil
stodsde	jih
ormu	orz
paez	pbb
mogum	mou
nenge	djk
lu	khb
napo lowland quechua	qvo
nathembo	nte
ayu	ayu
putukwam	afe
potiguara	pog
rural palestine arabic	ajp
pisaflores tepehua	tpp
adasen	tiu
huallaga quechua	qub
kabatei	xkp
punic	xpu
wagi	fad
dhanwar	dhw
mogholi	mhj
achinese	ace
central masela	mxz
sherpa	xsr
matu chin	hlt
kavet	krv
argobba	agj
austral	aut
elu	elu
laos sign language	lso
numana-nunku-gbantu-numbu	nbr
balau	blg
gikyode	acd
luidakho-luisukha-lutirichi	ida
batek	btq
enga	enq
saam	raq
umbindhamu	umd
sengseng	ssz
tampuan	tpu
antankarana malagasy	xmv
duwai	dbp
tho	tou
kickapoo	kic
dakka	dkk
siamou	sif
yola	yol
jofotek-bromnya	jbr
homa	hom
taulil	tuh
hu	huo
bariji	bjc
agatu	agc
north fali	fll
kwang	kvi
jiamao	jio
hone	juh
gamilaraay	kld
kolyma yukaghir	yux
sirenik yupik	ysr
jarawa	anq
south awyu	aws
darlong	dln
wano	wno
jad	jda
cashinahua	cbs
korra koraga	kfd
tobian	tox
mefele	mfj
pichis asheninka	cpu
orma	orc
mengisa	mct
nungali	nug
kodava	kfa
gugadj	ggd
judeo-arabic	jrb
ezaa	eza
moma	myl
lesing-gelimi	let
ana tinga dogon	dti
daai chin	dao
nalca	nlc
nahuatl + spanish	spa
maguindanaon	mdh
koireng	nkd
old aramaic	oar
alekano	gah
chachapoyas quechua	quk
southwestern guiyang hmong	hmg
northwestern kolami	kfb
anu-hkongso chin	anl
kituba	ktu
guttannen	gsw
nupbikha	npb
ratahan	rth
migabac	mpp
worodougou	jud
dondo	dok
east kewa	kjs
kereho	xke
valencian sign language	vsv
gbaya-bossangoa	gbp
komodo	kvh
southern bobo madare	bwq
ma'di	mhi
yine	pib
ersu	ers
mbongno	bgu
usui	usi
musey	mse
alak	alk
amoltepec mixtec	mbz
dogrib	dgr
rwa	rwk
oko-juwoi	okj
apiaka	api
kabalai	kvf
barikanchi	bxo
mabire	muj
dagbani	dag
northern bai	bfc
buyuan jinuo	jiy
dhuwal	dwu
nkoya	nka
birked	brk
bangwinji	bsj
bekwel	bkw
bafaw-balong	bwt
northern grebo	gbo
kupia	key
bangingih sama	sse
abkhaz	abk
nyishi	njz
tofanma	tlg
occitan	auv
biage	bdf
cogui	kog
zemba	dhm
tzotzil	tzz
langnian buyang	yln
putoh	put
nhengatu	yrl
koke	kou
konyanka maninka	mku
southern puebla mixtec	mit
wunambal	wub
banda-banda	bpd
siane	snp
bipi	biq
nocte naga	njb
muskum	mje
lola	lcd
kariya	kil
white gelao	giw
eman	emn
kaimbe	xai
kawi	kaw
mawchi	mke
syenara senoufo	shz
majera	xmj
mansoanka	msw
inor	ior
southern amami-oshima	ams
kamantan	kci
rejang	rej
amundava	adw
aka-kede	akx
bau	bbd
neme	nex
pulabu	pup
north marquesan	mrq
hajong	haj
sihuas ancash quechua	qws
northern pame	pmq
macaguan	mbn
mo'da	gbn
mpuono	zmp
seba	kdg
pima bajo	pia
plautdietsch	pdt
wasco-wishram	wac
ekpeye	ekp
mosiro	mwy
ngangam	gng
labo	mwi
mugom	muk
muthuvan	muv
koryak	kpy
isthmus-cosoleacaque nahuatl	nhk
yanomamo	guu
begbere-ejar	bqv
oyda	oyd
tai ya	cuu
kaiku	kkq
namonuito	nmt
tairuma	uar
enawene-nawe	unk
middle breton	xbm
bembe	bmb
vure	lkn
olkol	olk
ancient hebrew	hbo
kiwilwana	mlk
standard arabic	arb
thawa	xtv
attapady kurumba	pkr
orejon	ore
nyengo	nye
dghwede	dgh
lower chehalis	cea
nyunga	nys
jara	jaf
holikachuk	hoi
tonjon	tjn
northern kankanay	xnn
mende	men
adamorobe sign language	ads
bugawac	buk
ngatik men's creole	ngm
alamblak	amp
russia buriat	bxr
eastern frisian	frs
tututepec mixtec	mtu
ata	atm
dugwor	dme
gungu	rub
tepehua	tpt
nimanbur	nmp
wulna	wux
orowe	bpk
bangolan	bgj
kaang chin	ckn
duli-gey	duz
khlor	llo
miyako	mvi
izora	cbo
e'ma buyang	yzg
nalik	nal
bedjond	bjv
azoyu tlapanec	tpc
kire	geb
muduga	udg
moldova sign language	vsi
ghomara	gho
sundanese	sun
tesaka malagasy	tkg
ipulo	ass
korupun-sela	kpq
lambya	lai
koro wachi	bqv
batak karo	btx
old chinese	och
western huasteca nahuatl	nhw
iko	iki
central puebla nahuatl	ncx
amblong	alm
mailu	mgu
texistepec popoluca	poq
koba	kpd
lamet	lbn
pamosu	hih
numbami	sij
abaza	abq
mori atas	mzq
mamboru	mvd
bauchi	bsf
kamoro	kgq
ndam	ndm
hemba	hem
rajong	rjg
nisenan	nsz
pardhan	pch
yardliyawarra	yxl
paekche	pkc
nganakarti	xnk
malay	mly
dadi dadi	dda
sabah bisaya	bsy
muna	mnb
hernican	xhr
cajonos zapotec	zad
xhosa	xho
tyap	kcg
central awyu	awu
korandje	kcy
ashe	ahs
lisela	lcl
morigi	mdb
yotti	yot
comox	coo
simaa	sie
dhanki	dhn
lunda	lun
ayiwo	nfl
makyan naga	umn
arapaho	arp
kimki	sbt
central grebo	grv
pulaar	fuc
trieng	stg
miju-mishmi	mxj
ndoola	ndr
tangchangya	tnv
ngam	nmc
uneapa	bbn
vidunda	vid
hungana	hum
sunum	ymn
kua-nsi	ykn
aproumu aizi	ahp
central lalo	ywt
coquille	coq
nicarao	ppl
matbat	xmt
fongoro	fgr
serui-laut	seu
tee	tkq
mesme	zim
ndambomo	nxo
kenyan sign language	xki
gambera	gma
mpade	mpi
yaaku	muu
northern pastaza quichua	qvz
western tlacolula valley zapotec	zab
curonian	xcu
tukudede	tkd
ede idaca	idd
juruna	jur
sonaga	ysg
mofu	mfk
khaling	klr
novial	nov
marghi south	mfm
bekati'	bei
wanambre	wnb
bamenyam	bce
nisga'a	ncg
lihir	lih
pankhu	pkh
tenis	tns
namat	nkm
lakonde	mbg
peranakan	pea
pilipino	fil
luyana	lyn
samosa	swm
southern dong	kmc
cutchi-swahili	ccl
dixon reef	dix
southwestern tepehuan	tla
barclayville grebo	gry
ulwa	sum
cebaara senoufo	sef
ndut	ndv
thao	ssf
aeka	aez
towei	ttn
babuza	bzg
ullatan	ull
bengkala sign language	bqy
sileibi	sbq
gikuyu	kik
war-jaintia	aml
moroccan sign language	xms
samtao	stu
paumari	pad
ekit	eke
meyah	mej
ghera	ghr
western durango nahuatl	azn
sangisari	sgr
jaitmatang	xjt
ut-ma'in	gel
niellim	nie
hassaniyya	mey
mba	mfc
pfaelzisch	pfl
leningitij	lnj
duhwa	kbz
pacoh	pac
tai do	tyj
engenni	enn
gurindji kriol	gue
jalapa de diaz mazatec	maj
mvuba	mxh
siwai	siw
ugong	ugo
wadikali	wdk
mandeali	mjl
talysh	tly
bella coola	blc
baraamu	brd
groma	gro
baule	bci
kott	zko
campidanese sardinian	sro
makhuwa-moniga	mhm
bhattiyali	bht
kariri-xoco	kzw
fijian	fij
yabem	jae
wichi lhamtes guisnay	mzh
yutanduchi mixtec	mab
kataang	kgd
lengo	lgr
akar-bale	acl
siyin chin	csy
ikwo	iqw
jakalteko	jac
dadiya	dbd
botolan sambal	sbl
binongan itneg	itb
hrangkhol	hra
dazaga	dzg
thai	tha
malimba	mzd
warumungu	wrm
esan	ish
nyarafolo senoufo	sev
kotava	avk
southwestern huishui hmong	hmh
lamboya	lmy
saramaccan	srm
burji	bji
wersing	kvw
tokelau	tkl
pinai-hagahai	pnn
macuna	myy
talise	tlr
shom peng	sii
bargam	mlp
sika	ski
tawang monpa	twm
yawarawarga	yww
utarmbung	omo
san vicente coatlan zapotec	zpt
maramba	myd
jumla sign language	jus
kemi sami	sjk
dai zhuang	zhd
kinnauri	kfk
bassa	bsq
sulka	sua
kanu	khx
jingulu	jig
feroge	fer
koalib	kib
trio	tri
ruund	rnd
cao miao	cov
susu	sus
zaiwa	atb
yimchungru naga	yim
yugul	ygu
kanju	kbe
bats	bbl
lengola	lej
tomadino	tdi
achumawi	acv
orya	ury
northern tarahumara	thh
sio	xsi
jandai	jan
doso	dol
ambelau	amv
tahaggart tamahaq	thv
zia	zia
dza	jen
agavotaguerra	avo
zhoa	zhw
hebrew	heb
awiyaana	auy
middle welsh	wlm
lolo	llb
waima'a	wmh
kamta	rkt
western penan	pne
laki	lki
southwest pashayi	psh
saniyo-hiyewe	sny
mituku	zmq
sota kanum	krz
andaandi	dgl
ibino	ibn
lautu chin	clt
sama	slm
amanaye	ama
israeli sign language	isr
kuranko	knk
south watut	mcy
toro so dogon	dts
afar	aar
kurrama	vku
phrygian	xpg
mamuju	mqx
arequipa-la union quechua	qxu
hukumina	huw
yatee zapotec	zty
plains indian sign language	psd
wadjiginy	wdj
kunama	kun
panawa	pwb
tangkhul naga	nmf
phana'	phq
tzeltal	tzh
wadaginam	wdg
pardhi	pcl
mocovi	moc
tungag	lcm
khetrani	xhe
kayong	kxy
quioquitani-quieri zapotec	ztq
wandamen	wad
oroch	oac
od	odk
girawa	bbr
bussa	dox
kerinci	kvr
norra	nrr
xeta	xet
wailaki	wlk
logooli	rag
mazatlan mazatec	vmz
vishavan	vis
dandami maria	daq
mapena	mnm
galibi carib	car
barapasi	brp
gitonga	toh
ibaloi	ibl
anal	anm
principense	pre
mangbetu	mdj
tai	taw
south slavey	xsl
iyo	nca
a'ou	aou
agob	kit
walangama	nlw
ngumbi	nui
tinputz	tpz
yuhup	yab
southern toussian	wib
baure	brg
north efate	llp
murui huitoto	huu
tocantins asurini	asu
faliscan	xfa
lika	lik
classical portuguese	???
papasena	pas
paelignian	pgn
marino	mrb
yassic	ysc
southern luri	luz
shughni	sgh
sake	sak
torau	ttu
santali	sat
eastern maroon creole	djk
utu	utu
kalao	kly
nimoa	nmw
tawara	twl
southern betsimisaraka malagasy	bzc
dhundari	dhd
salas	sgu
njen	njj
havu	hav
pinotepa nacional mixtec	mio
q'anjob'al	kjb
tay boi	tas
ontenu	ont
taloki	tlk
salasaca highland quichua	qxl
karon	krx
luhu	lcq
angolar	aoa
luimbi	lum
chiduruma	dug
wambaya	wmb
marama	lrm
gen	gej
western mashan hmong	hmw
old cornish	oco
langobardic	lng
idere	ide
iduna	viv
karkar-yuri	yuj
ontong java	ojv
sonha	soi
ineseno	inz
fortsenal	frt
kok borok	trp
kayagar	kyt
emem	enr
kutang ghale	ght
nari nari	rnr
ju/'hoan	ktz
halia	hla
bijori	bix
mombo dogon	dmb
lishana deni	lsd
morawa	mze
yil	yll
rennellese sign language	rsi
tippera	tpe
lelak	llk
old ossetic	oos
alcozauca mixtec	xta
kafa	kbr
neo	neu
geme	geq
nyamwanga	mwn
tennet	tex
magoma	gmx
green hmong	blu
western katu	kuf
mah meri	mhe
nar phu	npa
agarabi	agd
dumpas	dmv
cheke holo	mrn
aweti	awe
dehu	dhv
naaba	nao
vafsi	vaf
ngardi	rxd
akha	ahk
coyotepec popoloca	pbf
gwichʼin	gwi
mbula	mna
razajerdi	rat
western arrarnta	are
kuruaya	kyr
nepalese sign language	nsp
unserdeutsch	uln
malaysian sign language	xml
kamaru	kgx
mossi	mos
sabah malay	msi
bure	bvh
yakama	yak
lai	cnh
ambakich	aew
nubaca	baf
tagabawa	bgs
zayein karen	kxk
malango	mln
pedi	nso
djeebbana	djj
tibetan	bod
musgu	mug
banda-yangere	yaj
yidgha	ydg
central hongshuihe zhuang	zch
calamian tagbanwa	tbk
chenchu	cde
koiari	kbk
sumariup	siv
ke'o	xxk
picard	pcd
adang	adn
yatzachi zapotec	zav
chesu	ych
sabum	sbo
guragone	gge
opuuo	lgn
salt-yui	sll
kaqchikel	cak
acoli	ach
hiri motu	hmo
gudang	xgd
kalamse	knz
woria	wor
semimi	etz
uruangnirin	urn
epigraphic mayan	emy
chipewyan	chp
wushi	bse
islander creole english	icr
aiwoo	nfl
foia foia	ffi
fyam	pym
pwo northern karen	pww
kigiryama	nyf
kayort	kyv
comanche	com
cuyamecalco mixtec	xtu
slavic	mkd
wanukaka	wnk
futuna-aniwa	fut
yei	jei
fernando po creole english	fpe
hindi	hin
yonaguni	yoi
oro	orx
kumaoni	kfy
ghari	gri
yucatec maya	yua
penoles mixtec	mil
ixtayutla mixtec	vmj
buxinhua	bgk
apinaye	apn
ukrainian sign language	ukl
kurnai	unn
satere-mawe	mav
istriot	ist
majukayang kalinga	kmd
akoye	miw
businenge tongo	djk
vlaams	vls
western pantar	lev
badaga	bfq
nyangumarta	nna
jair awyu	awv
kimatuumbi	mgw
warluwara	wrb
garingbal	xgi
malfaxal	mlx
guanano	gvc
wongo	won
fordata	frd
cacgia roglai	roc
ginuman	gnm
dagaare	dga
lang'e	yne
kosraean	kos
tandia	tni
shama-sambuga	sqa
nubian	onw
hmwaveke	mrk
siar-lak	sjr
kari	kbj
nen	baz
central khmer	khm
djamindjung	djd
flinders island	fln
ruma	ruz
papuma	ppm
scots	sco
ndali	ndh
molbog	pwm
bomu	bmq
tamagario	tcg
paku	pku
hpon	hpo
jilim	jil
uhami	uha
daba	dbq
bukharic	bhh
nungu	rin
waimiri-atroari	atr
dulbu	dbo
bongo	bot
yareni zapotec	zae
ancient north arabian	xna
para gaviao	gvp
binji	bpj
thracian	txh
mbariman-gudhinma	zmv
me'en	mym
kenati	gat
ganglau	ggl
irigwe	iri
busami	bsm
paraujano	pbg
lunanakha	luk
chichicapan zapotec	zpv
sicite senoufo	sep
kalasha	kls
lardil	lbz
orang seletar	ors
serudung murut	srk
nomane	nof
lahta	kvt
bajelani	bjm
wusa nasu	yig
bua	bub
kwakum	kwu
geez	gez
karas	kgv
humla	hut
aloapam zapotec	zaq
dharuk	xdk
zire	sih
southeastern ixtlan zapotec	zpd
aghu	ahh
usarufa	usa
southern mashan miao	hma
chitimacha	ctm
pa-hng	pha
sepik iwam	iws
dahalik	dlk
yaminahua	yaa
cara	cfd
jennu kurumba	xuj
ito	itw
blang	blr
jinyu chinese	cjy
lachixio zapotec	zpl
tharaka	thk
galolen	gal
ahtena	aht
/gwi	gwj
bondum dom dogon	dbu
manumanaw	kxf
awing	azo
guernesiais	nrf
carapana	cbc
wolio	wlo
mato grosso arara	axg
cuvok	cuv
aquitanian	xaq
laalaa	cae
etkywan	ich
maritime sign language	nsr
kabras	lkb
djangu	dhg
angaataha	agm
kwomtari	kwo
new caledonian javanese	jas
viemo	vig
early tripuri	xtr
kapori	khp
tepetotutla chinantec	cnt
tsakwambo	kvz
koreguaje	coe
mudburra	dmw
ledo kaili	lew
wik-me'anha	wih
arammba	stk
bishnupriya	bpy
kubi	kof
khayo	lko
alladian	ald
bhojpuri	bho
xokleng	xok
ewage-notu	nou
kanasi	soq
central k'iche'	quc
tai nua	tdd
e'napa woromaipu	pbh
eteocretan	ecr
miriwung	mep
bedawiyet	bej
katbol	tmb
pelende	ppp
kunigami	xug
finnish	fin
halbi	hlb
coast miwok	csi
mbonga	xmb
latin	lat
madurese	mad
ywom	gek
chukot	ckt
svenska	swe
dorze	doz
tarifit	rif
yuanga	nua
nicaragua creole english	bzk
wyandot	wya
slovene	slv
plains miwok	pmw
pouye	bye
lingao	onb
chiangmai sign language	csd
ati	atk
saurashtra	saz
holoholo	hoo
moabite	obm
rungus	drg
tai hongjin	tiz
shahrudi	shm
yucatec maya sign language	msd
pagi	pgi
dzodinka	add
moresada	msx
tumleo	tmq
rao	rao
yoy	yoy
west-central limba	lia
ngiemboon	nnh
fasu	faa
mari	mhr
kahe	hka
makassar malay	mfp
kabutra	kbu
masmaje	mes
blablanga	blp
kolibugan subanon	skn
tsimane	cas
cinta larga	cin
berik	bkl
namiae	nvm
siriano	sri
serrano	ser
damakawa	dam
mundari	muw
chamorro	cha
tabassaran	tab
murkim	rmh
bushi	buc
surgujia	sgj
nooksack	nok
ngwo	ngn
iau	tmu
kisa	lks
dongo	doo
el molo	elo
muinane	bmr
lamas kechwa	qvs
nauru	nau
ambulas	abt
waama	wwa
libon bikol	lbl
senggi	snu
hieroglyphic luwian	hlu
torricelli	tei
samba leko	ndi
min nan chinese	nan
boga	bvw
rathawi	rtw
jerriais	nrf
gavak	dmc
embu	ebu
alege	alf
bini	bin
lusengo	lse
faita	faj
bom	bmf
baram kayan	kys
mudbarra	mwd
ede nago	nqk
tikar	tik
korop	krp
ayoreo	ayo
zazao	jaj
yazgulyam	yah
tingui-boto	tgv
bara malagasy	bhr
laura	lur
pasi	psq
lipo	lpo
andaqui	ana
neyo	ney
nora	nrr
flemish sign language	vgt
longuda	lnu
hattic	xht
gbaya-bozoum	gbq
kalmyk	xal
mesopotamian arabic	acm
cashibo-cacataibo	cbr
cuneiform luwian	xlu
nukumanu	nuq
giryama	nyf
bamako sign language	bog
younuo bunu	buh
barombi	bbi
egyptian arabic	arz
hunde	hke
southern pumi	pmj
pite sami	sje
antigua and barbuda creole english	aig
chazumba mixtec	xtb
afrihili	afh
swiss-french sign language	ssr
varhadi-nagpuri	vah
fum	fum
cameroon mambila	mcu
aribwatsa	laz
tugutil	tuj
elfdalian	ovd
venetian	vec
malgana	vml
dalmatian	dlm
umon	umm
kurudu	kjr
mangas	zns
ketengban	xte
kushi	kuh
lanoh	lnh
hoava	hoa
kambaira	kyy
pumpokol	xpm
maonan	mmd
yatay	yty
ngbee	jgb
omie	aom
koronadal blaan	bpr
pholo	yip
lewo eleng	lwe
xicotepec de juarez totonac	too
apatani	apt
kemak	kem
rawngtu chin	weu
judeo-georgian	jge
pidgin delaware	dep
chane	caj
quiche	quc
ebira	igb
galindan	xgl
gusilay	gsl
urapmin	urm
mong leng	hnj
bumbita arapesh	aon
kuk	kfn
poke	pof
goreng	xgg
arabela	arl
tsamai	tsb
mintil	mzt
ukhwejo	ukh
kaniet	ktk
dzamba	kng
waigeo	wgo
luang	lex
seru	szd
north asmat	nks
warlmanpa	wrl
kajali	xkj
binukid	bkd
azoyu me'phaa	tpc
irula	iru
tsishingini	tsw
psikye	kvj
ik	ikx
jhankot sign language	jhs
ubang	uba
ari	aac
ayoquesco zapotec	zaf
warlpiri	wbp
mwaghavul	sur
kwerba	kwe
tupari	tpr
yuwana	yau
sankaran maninka	msc
camunic	xcc
limassa	bme
sapuan	spu
uruava	urv
dayi	dax
pitcairn-norfolk	pih
siarlak	sjr
ngoni	nse
aulua	aul
ogbogolo	ogg
bhunjia	bhu
algonquin	alq
udihe	ude
kipfokomo	pkb
ika	arh
inabaknon	abx
min dong chinese	cdo
maisin	mbq
southwest palawano	plv
old lardil	???
nek	nif
ngundi	ndn
west tarangan	txn
vumbu	vum
jaru	ddj
nyang'i	nyp
margos-yarowilca-lauricocha quechua	qvm
niwer mil	hrc
tokharian a	xto
kujarge	vkj
nubri	kte
merlav	mrm
northern talyshi	tly
central mashan hmong	hmm
russian sign language	rsl
suba	sxb
early modern english	???
esperanto	epo
navut	nsw
kumzari	zum
mawes	mgk
kamo	kcq
mobumrin aizi	ahm
min bei chinese	mnp
mainstream kenyah	xkl
mandobo atas	aax
warapu	wra
koya	kff
bahing	bhj
naami	bzv
ai-cham	aih
nehan	nsn
maleku jaika	gut
mikasuki	mik
plapo krumen	ktj
simte	smt
nawdm	nmz
kube	kgf
tumi	kku
san miguel creole french	scf
pa'o karen	blk
tswa	tsc
llengua de signes valenciana	vsv
kahua	agw
phunoi	pho
embaloh	emb
ogea	eri
pengo	peg
guezenaya taryfit berber	rif
mong	hmn
lamalera	lmr
angloromani	rme
kamakan	vkm
apurina	apu
taino	tnq
cimbrian	cim
montol	mtl
itawit	itv
western sisaala	ssl
bangi	bni
pero	pip
sanskrit	san
kaapor	urb
mele-fila	mxe
langi	laj
bagupi	bpi
acatepec tlapanec	tpx
tucano	tuo
chamacoco	ceg
cacaloxtepec mixtec	miu
puyuma	pyu
idu-mishmi	clk
zimbabwe sign language	zib
tosk albanian	als
tamahaq	thv
norwegian sign language	nsl
balinese	ban
buksa	tkb
akrukay	afi
chechen	che
umatilla	uma
potawatomi	pot
laro	lro
west albay bikol	fbl
gidar	gid
flemish	vls
teke-kukuya	kkw
kurtokha	xkz
coatecas altas zapotec	zca
central mazahua	maz
lawunuia	tgi
tecpatlan totonac	tcw
bukwen	buz
kunyi	njx
danaru	dnr
kungardutyi	gdt
gule	gly
ottoman turkish	ota
sugut dusun	kzs
karakhanid	xqa
manza	mzv
bundeli	bns
da-hua miao	hmd
quebec sign language	fcs
garrwa	wrk
kikai	kzg
duguri	dbm
kuke	ght
burui	bry
nuu-chah-nulth	nuk
achuar-shiwiar	acu
veddah	ved
bahamas creole english	bah
ega	ega
lemerig	lrz
mamasa	mqj
chiga	cgg
eloyi	afo
kowiai	kwh
malvi	mup
assan	xss
east berawan	zbe
tuwuli	bov
ifo	iff
lenca	len
modang	mxd
chuave	cjv
bahinemo	bjh
nuosu	iii
nzima	nzi
weyto	woy
guinea kpelle	gkp
kyak	bka
bwa	bww
western bolivian guarani	gnw
koongo	kng
tezoatlan mixtec	mxb
narragansett	xnt
tiemacewe bozo	boo
fore	for
nyindu	nyg
yurok	yur
xiri	xii
kiput	kyi
dori'o	dor
wuliwuli	wlu
toto	txo
badiotto	lld
kutep	kub
abar	mij
daungwurrung	dgw
rara bakati'	lra
khehek	tlx
akkala sami	sia
brunei bisaya	bsb
sauraseni prakrit	psu
elip	ekm
mansi	mns
kioko	ues
teutila cuicatec	cut
kɛlɛngaxo bozo	bzx
tichurong	tcn
minjungbal	xjb
goaria	gig
matumbi	mgw
la'bi	lbi
tulu	tcy
ninde	mwi
botlikh	bph
birgit	btf
tanudan kalinga	kml
ojitlan chinantec	chj
northern hindko	hno
ngarinyin	ung
epi-olmec	xep
ingush	inh
swiss-italian sign language	slf
bambam	ptu
ufim	ufi
omani arabic	acx
phimbi	phm
old norse	non
uma' lasan	xky
lamu	llh
kabyle	kab
jawe	jaz
hani	hni
labrador inuttut	ike
guguyimidjir	kky
shilluk	shk
northern pumi	pmi
guinean sign language	gus
popti'	jac
tontemboan	tnt
odoodee	kkc
riung	riu
marrucinian	umc
molmo one	aun
urubu-kaapor sign language	uks
palu'e	ple
aragonese	arg
southern guiyang miao	hmy
kutchi	kfr
bolinao	smk
bungain	but
mbunda	mck
warwar feni	hrw
rana tharu	thr
yalunka	yal
dek	dek
khonso	kxc
minderico	drc
yuruti	yui
abure	abu
wangkumara	nbx
bwisi	bwz
sinhala	sin
achterhoeks	act
aiklep	mwg
ningil	niz
wampanoag	wam
djabwurrung	tjw
baeggu	bvd
dameli	dml
sukurum	zsu
punjabi	pan
wayoro	wyr
san baltazar loxicha zapotec	zpx
iyojwa'ja chorote	crt
pinjarup	pnj
western tawbuid	twb
west berawan	zbw
huarijio	var
knaanic	czk
arop-sissano	aps
ampari dogon	aqd
anca	acb
yiningayi	ygi
cahuarano	cah
yamap	ymp
okobo	okb
oroqen	orh
chaldean neo-aramaic	cld
doghoro	dgx
kalumpang	kli
aromanian	rup
menik	tnr
korafe-yegha	kpr
gbiri-niragu	grh
tutsa naga	tvt
zhaba	zhb
qaqet	byx
nyaneka	nyk
te'un	tve
mobwa karen	jkm
awad bing	bcu
datooga	tcc
meriam	ulk
bobongko	bgb
mentawai	mwv
yagwoia	ygw
tedaga	tuq
gros ventre	ats
eastern mari	mhr
gugu badhun	gdc
kwara'ae	kwf
xamtanga	xan
lepcha	lep
sekar	skz
tagal murut	mvv
romano-serbian	rsb
laurentian	lre
wapishana	wap
west central oromo	gaz
lama bai	lay
wampur	waz
jeh	jeh
oya'oya	oyy
korak	koz
north picene	nrp
una	mtg
kobiana	kcj
nusu	nuf
koroshi	ktl
nepal bhasa	new
goemai	ank
tambas	tdk
fula	fuv
aore	aor
zotung chin	czt
old korean	oko
pokoot	pko
tsotsitaal	fly
braj	bra
ruga	ruh
konzo	koo
northern alta	aqn
siksika	bla
juray	juy
chak	ckh
gichuka	cuh
okinawan	ryu
burunge	bds
southern one	osu
wala	lgl
obolo	ann
hermit	llf
polari	pld
wambule	wme
abidji	abi
menka	mea
k'iche'	quc
sauria paharia	mjt
chakali	cli
gaviao do jiparana	gvo
enlhet	enl
sicanian	sxc
kedah malay	meo
north watut	una
uripiv-wala-rano-atchin	upv
shiki	gua
kaikavian literary language	kjv
balti	bft
swiss german	gsw
laua	luf
sahu	saj
croatian	hrv
official aramaic	arc
chalikha	tgf
adonara	adr
(undetermined)	und
mfinu	zmf
uab meto	aoz
southern sami	sma
bafut	bfd
ngarluma	nrl
toaripi	tqo
lake miwok	lmw
karao	kyj
dombe	dov
itonama	ito
unua	onu
lotuho	lot
nuer	nus
wanman	wbt
tiagbamrin aizi	ahi
mabaale	mmz
tafi	tcd
lubu	lcf
!kung	knw
chilean sign language	csg
panobo	pno
pingelapese	pif
hyam	jab
dabarre	dbr
iberian	xib
karnic	ekc
tuotomb	ttf
matipuhy	mzo
bariai	bch
afghan persian	prs
valpei	vlp
mongo	lol
kpan	kpk
mungkip	mpv
isthmus zapotec	zai
wudu	wud
awngi	awn
borong	ksr
somrai	sor
tchumbuli	bqa
chrau	crw
norwegian nynorsk	nno
thu lao	tyl
slovenian	slv
old hittite	oht
gumalu	gmu
malaynon	mlz
warnang	wrn
wayu	vay
usan	wnu
igbo	ibo
central huishui hmong	hmc
kenga	kyq
neo-hittite	nei
bilur	bxf
awabakal	awk
layakha	lya
olumarama	lrm
peve	lme
masai	mas
sempan	xse
central pame	pbs
el nayar cora	crn
rumai palaung	rbb
ratagnon	btn
oorlams	oor
sri lankan sign language	sqs
kpagua	kuw
jamsay dogon	djm
apali	ena
nkukoli	nbo
lutachoni	lts
kumbainggar	kgs
birhor	biy
francisco leon zoque	zos
artificial language	*xxx*
ucayali-yurua asheninka	cpb
hlersu	hle
sengo	spk
musar	mmi
erre	err
gusan	gsn
low saxon	nds
southern tidung	itd
paakantyi	drl
scottish gaelic	gla
hiligaynon	hil
pogolo	poy
silt'e	stv
waropen	wrp
kove	kvc
iwur	iwo
kuanyama	kua
tuyuca	tue
lamja-dengsa-tola	ldh
kako	kkj
ronga	rng
krymchak	jct
amio-gelimi	let
kamarian	kzx
judeo-yemeni arabic	jye
rendille	rel
hoan	ktz
atayal	tay
maybrat	ayz
mbunga	mgy
ayautla mazatec	vmy
katso	kaf
sarli	sdf
tenino	tqn
kaidipang	kzp
sampang	rav
etulo	utr
standard moroccan tamazight	zgh
pijao	pij
coong	cnc
khalaj	klj
samaritan aramaic	sam
mohegan-pequot	xpq
kala	kcl
logol	lof
nasal	nsy
kapya	klo
bokoto	bdt
yarluyandi	yry
urimo	urx
maore comorian	swb
eastern xwla gbe	gbx
nyaturu	rim
teanu	tkw
southeastern tepehuan	stp
dar fur daju	daj
kadu	zkd
kwer	kwr
old tibetan	otb
gimme	kmp
anambe	aan
tatar	tat
kazakh	kaz
mayi-thakurti	xyt
darang deng	mhu
akyaung ari naga	nqy
lumba-yakkha	luu
atampaya	amz
northern east cree	crl
ditammari	tbz
ishkashimi	isk
rapoisi	kyx
karok	kyh
shangzhai	jih
angosturas tunebo	tnd
mer	mnu
yakha	ybh
kuanhua	xnh
njalgulgule	njl
mpiemo	mcx
boon	bnl
kayardild	gyd
tututni	tuu
juwal	mwb
finlandssvenskt teckensprak	fss
hausa sign language	hsl
pagu	pgu
mum	kqa
langue des signes de belgique francophone	sfb
napu	npy
nyaheun	nev
oki-no-erabu	okn
watiwa	wtf
veps	vep
ulch	ulc
kayupulau	kzu
kayabi	kyz
southeastern kolami	nit
mara chin	mrh
nopala chatino	cya
guaja	gvj
katabaga	ktq
heung kong sau yue	hks
arguni	agf
bun	buv
uru-eu-wau-wau	urz
southern pame	pmz
day	dai
lalana chinantec	cnl
chenoua	cnu
barbareno	boi
guatemalan sign language	gsm
cabecar	cjp
mundat	mmf
caquinte	cot
tongwe	tny
bliss	zbl
angaite	aqt
ayacucho quechua	quy
mbulungish	mbv
australian sign language	asf
tebul sign language	tsy
dong	kmc
molima	mox
santa maria del mar huave	hvv
alangan	alj
yucuane mixtec	mvg
kuuk-yak	uky
embera-chami	cmi
sabaean	xsa
yosondua mixtec	mpm
nggwahyi	ngx
wakhi	wbl
jebero	jeb
vale	vae
kpeego	cpo
nankina	nnk
northern sierra miwok	nsq
basketo	bst
bakairi	bkq
lamaholot	slp
chut	scb
yan-nhaŋu sign language	yhs
kabola	klz
yamphu	ybi
bermeo occidental	eus
emplawas	emw
gwak	jgk
wapan	juk
pontic	pnt
higaonon	mba
mpoto	mpa
teressa	tef
agusan manobo	msm
buna	bvn
atzingo matlatzinca	ocu
manikion	mnx
irish sign language	isg
galatian	xga
miya	mkf
mbuko	mqb
kutu	kdc
slovakian sign language	svk
munsee	umu
southern balochi	bcc
bondo	bfw
geji	gji
ali	aiy
rajasthani	raj
biwat	bwm
paleni	pnl
mualang	mtd
nenets	yrk
eten	etx
khams tibetan	khg
kanga	kcp
algerian arabic	arq
taupota	tpa
pwapwa	pop
burushaski	bsk
geser-gorom	ges
kulina	cul
waritai	wbe
mpi	mpz
imonda	imn
yuracare	yuz
kaba	ksp
tetete	teb
buglere	sab
kedang	ksx
northern tlaxiaco mixtec	xtn
menya	mcr
hupa	hup
gooniyandi	gni
laopang	lbg
chiquihuitlan mazatec	maq
namo	mxw
malayalam	mal
nandi	niq
pagibete	pae
muniche	myr
kuku-mangk	xmq
wiradhuri	wrh
tamanaku	tmz
tswapong	two
gagnoa bete	btg
togbo-vara banda	tor
lobire	lob
spokane	spo
zhuang	ccx
southern binukidnon	mtw
dime	dim
atemble	ate
penrhyn	pnh
lama	las
duala	dua
wariyangga	wri
lakha	lkh
halkomelem	hur
benabena	bef
chimakum	xch
en	enc
nottoway	ntw
anufo	cko
bagirmi fulfulde	fui
wayuu	guc
kangri	xnr
ngoshie	nsh
tlamacazapa nahuatl	nuz
angguruk yali	yli
yaeyama	rys
sunam	ssk
kusunda	kgg
chuvantsy	xcv
yambes	ymb
shamang	xsh
horpa	ero
southwest tanna	nwi
totela	ttl
bukiyip	ape
adzera	azr
kawacha	kcb
sholaga	sle
kalkutung	ktg
laeko-libuat	lkl
kunbarlang	wlg
baramu	bmz
southern mashan hmong	hma
morom	bdo
laghuu	lgh
miraya bikol	rbl
indonesian	ind
zenag	zeg
peere	pfe
kokola	kzn
liuqian zhuang	zlq
daloa bete	bev
warembori	wsa
tai laing	tjl
raute	rau
edopi	dbf
maeng itneg	itt
bozaba	bzo
karaja	kpj
selkup	sel
beembe	beq
ge	hmj
kinande	nnb
bade	bde
bonkeng	bvg
pictish	xpi
nataoran amis	ais
takwane	tke
standard estonian	ekk
panyi bai	bfc
diri	dwa
shahmirzadi	srz
ebrie	ebr
northern dagara	dgi
allar	all
viid	snu
babango	bbm
nyanga-li	nyc
tanema	tnx
chodri	cdi
baetora	btr
puoc	puo
biyom	bpm
forest enets	enf
baloi	biz
kerewe	ked
lega-mwenga	lgm
bannoni	bcm
kilivila	kij
turiwara	twt
diebroud	tbp
tukang besi south	bhq
'oroe	bpk
tavringer romani	rmu
bumthangkha	kjz
orokaiva	okv
old japanese	ojp
catalan	cat
forak	frq
mamara senoufo	myk
pakanha	pkn
old hungarian	ohu
ese ejja	ese
suruaha	swx
kpessi	kef
masbatenyo	msb
ulau-suain	svb
kembra	xkw
noric	nrc
kosli	spv
lagwan	kot
western karaboro	kza
xaasongaxango	kao
harari	har
wambon	wms
pawaia	pwa
gban	ggu
calo	rmq
unubahe	unu
northern pomo	pej
mortlockese	mrl
northern subanen	stb
cocama-cocamilla	cod
maiani	tnh
umbuygamu	umg
burdekin	xbb
manyawa	mny
huizhou chinese	czh
kendem	kvm
wappo	wao
cappadocian greek	cpg
mondropolon	npn
ligbi	lig
narrinyeri	nay
northwestern !kung	vaj
ket	ket
scythian	xsc
gahri	bfu
futuna	fud
eastern tamang	taj
kulina pano	xpk
afrikaans	afr
avokaya	avu
xibe	sjo
moroccan arabic	ary
inapang	mzu
sora	srb
central atlas tamazight	tzm
ngbundu	nuu
lampung nyo	abl
oring	org
totoro	ttk
medebur	mjm
lwalu	lwa
kasiguranin	ksn
basa-gumna	bsl
creole hindi	hca
lega-shabunda	lea
old spanish	osp
san jeronimo tecoatl mazatec	maa
ardhamagadhi prakrit	pka
jilbe	jie
sonde	shc
wauyai	wuy
huamalies-dos de mayo huanuco quechua	qvh
tase naga	nst
ogbah	ogc
san salvador kongo	kwy
aushiri	avs
lote	uvl
bukusu	bxk
northern gondi	gno
ho-chunk	win
churahi	cdj
persian sign language	psc
sirmauri	srx
megam	mef
eastern canadian inuktitut	ike
isekiri	its
shor	cjs
umeda	upi
kimre	kqp
zeeuws	zea
oloma	olm
northern kissi	kqs
miqie	yiq
catalonian sign language	csc
ambai	amk
letzeburgesch	ltz
nalu	naj
gedaged	gdd
birale	bxe
tswana	tsn
aleut	ale
simba	sbw
sowanda	sow
oraon sadri	sdr
rahambuu	raz
skagit	ska
berau malay	bve
dima	jma
northern luri	lrc
ghotuo	aaa
canela	ram
inapari	inp
adithinngithigh	dth
luna	luj
old burmese	obr
lakota	lkt
avar	ava
gula iro	glj
western yiddish	yih
twendi	twn
tu	mjg
milyan	imy
gvoko	ngs
yan-nhangu	jay
emai-iuleha-ora	ema
mising	mrg
munji	mnj
latunde	ltn
kota bangun kutai malay	mqg
assiniboine	asb
castilian	spa
lehali	tql
machiguenga	mcb
anem	anz
kharam naga	kfw
dhuwaya	dwy
maa	cma
tajuasohn	tja
grass koiari	kbk
dobu	dob
caac	msq
pileni	piv
arapesh	aoj
awak	awo
hungworo	nat
nyangatom	nnj
anfillo	myo
broome pearling lugger pidgin	bpl
cun	cuq
pahari-potwari	phr
shall-zwall	sha
