church slavonic	chu	
krobu	kxb	
samvedi	smv	
danish	dan	rmd	
cuba	cbq	
shua	shg	
sileibi	sbq	
unggumi	xgu	
south nuaulu	nxl	
moro	mor	
kɛlɛngaxo bozo	bzx	
sarasira	zsa	
iresim	ire	
bakoko	bkh	
awngthim	gwm	
kungardutyi	gdt	
biao-jiao mien	bje	
abnaki	aaq	abe	
lambadi	lmn	
old lardil	lbz	
habu	hbu	
calamian tagbanwa	tbk	
luopohe hmong	hml	
amdang	amj	
bagusa	bqb	
baskisch	eus	
ong	oog	
etchemin	etc	
warnang	wrn	
(undetermined)	und	
toqabaqita	mlu	
kacipo-balesi	koe	
vangunu	mpr	
khonso	kxc	
kara-kalpak	kaa	
sinaugoro	snc	
ndonde hamba	njd	
i'saka	ksi	
ngbee	jgb	
yautepec zapotec	zpb	
breton	bre	obt	xbm	
bontok	bnc	ebk	lbk	obk	rbk	vbk	
mamara senoufo	myk	
mubami	tsx	
central awyu	awu	
northern qiang	cng	
oko-eni-osayen	oks	
karajá	kpj	
wik-me'anha	wih	
kunama	kun	
maritime sign language	nsr	
kwambi	kwm	
warrwa	wwr	
chonyi-dzihana-kauma	coh	
awun	aww	
tukang besi north	khc	
giyug	giy	
kulon-pazeh	uun	
mundabli	boe	
barikanchi	bxo	
okpe (northwestern edo)	okx	
magori	zgr	
grenadian creole english	gcl	
kayapó	txu	
hrangkhol	hra	
yawuru	ywr	
bine	bon	
salar	slr	
keder	kdy	
mangseng	mbh	
bintulu	bny	
mala (nigeria)	ruy	
farefare	gur	
ma (papua new guinea)	mjn	
tat	ttt	
shall-zwall	sha	
potawatomi	pot	
arapaho	arp	
beja	bej	
mandahuaca	mht	
bisorio	bir	
hixkaryána	hix	
puyo	xpy	
garrwa	wrk	
no linguistic content	zxx	
navajo	nav	
written oirat	xwo	
tyaraity	woa	
nonuya	noj	
maraghei	vmh	
northern tidung	ntd	
jakati	jat	
mvanip	mcj	
kreye	xre	
ararandewára	xaj	
lyons sign language	lsg	
bebil	bxp	
tlacoapa me'phaa	tpl	
middle welsh	wlm	
ginyanga	ayg	
lakota dida	dic	
bolinao	smk	
beembe	beq	
northern frisian	frr	
pardhan	pch	
rejang kayan	ree	
semnam	ssm	
bedjond	bjv	
gbanu	gbv	
fortsenal	frt	
con	cno	
owiniga	owi	
nihali	nll	
ezaa	eza	
ashtiani	atn	
bokyi	bky	
tiéyaxo bozo	boz	
miluk	iml	
panamint	par	
gebe	gei	
lulogooli	rag	
pyapun	pcw	
nyenkha	neh	
sinicahua mixtec	xti	
bwile	bwc	
wergaia	weg	
wik-keyangan	wif	
jowulu	jow	
ningera	nby	
waama	wwa	
moru	mgd	
koorete	kqy	
mondé	mnd	
mulaha	mfw	
kanakanabu	xnb	
emem	enr	
nopala chatino	cya	
geser-gorom	ges	
isconahua	isc	
songway kiini	tst	
sikkimese	sip	
dampelas	dms	
pictish	xpi	
bwisi	bwz	
bactrian	xbc	
lele	lln	
fanamaket	bjp	
aghu-tharnggala	gtu	
lun bawang	lnd	
southwestern guiyang hmong	hmg	
minang	xrg	
majera	xmj	
bankagooma	bxw	
uab meto	aoz	
adygei	ady	
a-hmaos	hmd	
yei	jei	
wangaaybuwan-ngiyambaa	wyb	
bitare	brt	
gor	gqr	
selungai murut	slg	
paliyan	pcf	
northwest gbaya	gya	
doromu-koki	kqc	
mesqan	mvz	
rembong	reb	
kota (gabon)	koq	
ke'o	xxk	
nubri	kte	
rennellese sign language	rsi	
godié	god	
nahari	nhh	
waja	wja	
kirdki	zza	
kogi	kog	
baibai	bbf	
angloromani	rme	
konkani (macrolanguage)	kok	
bargam	mlp	
northern emberá	emp	
cuzco quechua	quz	
cen	cen	
matumbi	mgw	
duala	dua	
som	smc	
broome pearling lugger pidgin	bpl	
yámana	yag	
lohorung	lbr	
kayan	bfg	kys	pdu	ree	whu	xkd	xkn	
neme	nex	
tacana	tna	
sallands	sdz	
pima bajo	pia	
diriku	diu	
kako	kkj	
yagomi	ygm	
tutsa naga	tvt	
tulu-bohuai	rak	
mbyá guaraní	gun	
gilyak	niv	
huallaga quechua	qub	
southern catanduanes bikol	bln	
puluwatese	puw	
araweté	awt	
tunisian arabic	aeb	
wathawurrung	wth	
yuracare	yuz	
kuot	kto	
aka-bea	abj	
tinigua	tit	
keak	keh	
kachhi	kfr	
ngulu	ngp	
vaghua	tva	
bajelani	bjm	
chilcotin	clc	
totoro	ttk	
nyunga	nys	
middle mongolian	xng	
pu-xian chinese	cpx	
tecpatlán totonac	tcw	
interlingua (international auxiliary language association)	ina	
hmong don	hmf	
yafi	wfg	
central kurdish	ckb	
north awyu	yir	
poqomchi'	poh	
kurukh	kru	
burak	bys	
irula	iru	
jauja wanca quechua	qxw	
tumari kanuri	krt	
ralte	ral	
lamogai	lmg	
sardinian	sdc	sdn	src	srd	sro	
onjob	onj	
dahalo	dal	
cicipu	awc	
wogeo	woc	
takelma	tkm	
pukapuka	pkp	
gera	gew	
pemon	aoc	
loncong	lce	
banda malay	bpq	
livvi	olo	
kasua	khs	
monzombo	moj	
amio-gelimi	let	
ngarigu	xni	
savosavo	svs	
sekani	sek	
babine	bcr	
dhalandji	dhl	
lauan	llx	
uda	uda	
creek	mus	
pisaflores tepehua	tpp	
jimi (nigeria)	jmi	
kairiru	kxa	
filipino	fil	
boor	bvf	
oniyan	bsc	
klao	klu	
kimatuumbi	mgw	
adnyamathanha	adt	
bom	bmf	
taushiro	trr	
makwe	ymk	
gitonga	toh	
elepi	ele	
kusu	ksv	
bunaba	bck	
moi (indonesia)	mxn	
adivasi oriya	ort	
mobilian	mod	
khowar	khw	
megam	mef	
isanzu	isn	
kanashi	xns	
lomwe	lon	ngl	
ömie	aom	
ambae	nnd	omb	
en	enc	
ngizim	ngi	
loun	lox	
tlacolula valley zapotec	zab	
tembo (motembo)	tmv	
tonga (nyasa)	tog	
numèè	kdk	
djangun	djf	
vafsi	vaf	
walrpiri	wbp	
iberian	xib	
philippine sign language	psp	
ese ejja	ese	
judeo-georgian	jge	
fali	fah	fal	fli	fll	
hai//om	hgm	
chopi	cce	
duvle	duv	
swiss-german sign language	sgg	
ditammari	tbz	
kudu-camo	kov	
gugadj	ggd	
yolŋu sign language	ygs	
ho	hoc	
moksela	vms	
cocopa	coc	
bidiyo	bid	
chut	scb	
lojban	jbo	
ganggalida	gcd	
wayu	vay	
nancere	nnc	
barikewa	jbk	
southern tujia	tjs	
wapan	juk	
madurese	mad	
warlpiri	wbp	
budong-budong	bdx	
kuamasi	yku	
temi	soz	
larteh	lar	
lusi	khl	
makyan naga	umn	
burate	bti	
acatepec tlapanec	tpx	
gamilaraay	kld	
lealao chinantec	cle	
gobu	gox	
ambelau	amv	
providencia sign language	prz	
sakirabiá	skf	
yongnan zhuang	zyn	
sibe	nco	
baule	bci	
saamia	lsm	
ne ambae	omb	
kokola	kzn	
rajong	rjg	
pak-tong	pkg	
matbat	xmt	
hya	hya	
nyole	nuj	
terebu	trb	
yoron	yox	
movima	mzp	
chehalis	cea	cjh	
nukak makú	mbr	
toromono	tno	
ocotepec mixtec	mie	
central siberian yupik	ess	
alune	alp	
wahau kenyah	whk	
twi	twi	
moingi	mwz	
koronadal blaan	bpr	
babalia creole arabic	bbz	
abelam	abt	
isirawa	srl	
kosraean	kos	
igana	igg	
mawes	mgk	
paite chin	pck	
desano	des	
north bolivian quechua	qul	
bembe	bmb	
lopi	lov	
ibuoro	ibr	
old hittite	oht	
bende	bdp	
kam	kdx	
halang	hal	
day	dai	
aulua	aul	
mirandese	mwl	
aneityum	aty	
kuku-mangk	xmq	
lisela	lcl	
atakapa	aqp	
minica huitoto	hto	
lycian	xlc	
petjo	pey	
duwai	dbp	
lonwolwol	crc	
qiubei zhuang	zqe	
lamnso'	lns	
suma	sqm	
serui-laut	seu	
ava guaraní	nhd	
abom	aob	
makassar malay	mfp	
tandroy-mahafaly malagasy	tdx	
cisalpine gaulish	xcg	
attié	ati	
nomatsiguenga	not	
gorap	goq	
stoney	sto	
yau (sandaun province)	yyu	
barclayville grebo	gry	
kubi	kof	
kulung (nepal)	kle	
donno so dogon	dds	
warwar feni	hrw	
ban khor sign language	bfk	
gade	ged	
tae'	rob	
pinai-hagahai	pnn	
lake miwok	lmw	
southern qiandong miao	hms	
arhuaco	arh	
beneraf	bnv	
veddah	ved	
koyra chiini	khq	
kalkoti	xka	
hoan	ktz	
cuyamecalco mixtec	xtu	
warapu	wra	
alangan	alj	
swedish	swe	
tswapong	two	
northern nisu	yiv	
tai pao	tpo	
che	ruk	
boo	bqc	
bindal	xbd	
puroik	suv	
malagasy	bhr	bmm	bzc	mlg	msh	plt	skg	tdx	tkg	txy	xmv	xmw	
gbagyi	gbr	
mairasi	zrs	
chumburung	ncu	
cajatambo north lima quechua	qvl	
kanjobal	kjb	knj	
hulung	huk	
bebeli	bek	
karekare	kai	
sila	slt	
central dusun	dtp	
jara	jaf	
boguru	bqu	
bauchi	bsf	
maramba	myd	
suganga	sug	
tanzanian sign language	tza	
manam	mva	
eastern canadian inuktitut	ike	
bau	bbd	
taman (indonesia)	tmn	
tanosy malagasy	txy	
gbaya-bozoum	gbq	
northern ghale	ghh	
mortlockese	mrl	
susu	sus	
sajau basap	sjb	
nankina	nnk	
emberá-catío	cto	
utu	utu	
yuchi	yuc	
south awyu	aws	
tigre	tig	
yassic	ysc	
andegerebinha	adg	
southern yukaghir	yux	
akyaung ari naga	nqy	
naasioi	nas	
koreguaje	coe	
southern amami-oshima	ams	
kamayurá	kay	
memoni	mby	
goundo	goy	
yamba	yam	
ranglong	rnl	
mambai	mcs	
aneme wake	aby	
tasmanian	xtz	
lave	brb	
fang (equatorial guinea)	fan	
nyangbo	nyb	
wambaya	wmb	
khua	xhv	
kolami	kfb	nit	
dongshanba lalo	yik	
neku	nek	
anii	blo	
navaho	nav	
zinza	zin	
dombe	dov	
yaosakor asmat	asy	
paulohi	plh	
māhārāṣṭri prākrit	pmh	
kadiwéu	kbc	
shau	sqh	
ukrainian	ukr	
hamap	hmu	
gende	gaf	
pouye	bye	
bena (tanzania)	bez	
norse	non	
koyra chiini songhay	khq	
bua	bub	
kaansa	gna	
wangganguru	wgg	
wunumara	wnn	
ndau	ndc	
piratapuyo	pir	
musi	mui	
silt'e	stv	
francisco león zoque	zos	
unubahe	unu	
monoalu	mte	
tala	tak	
ndemli	nml	
omaha-ponca	oma	
parthian	xpr	
classical nahuatl	nci	
bepour	bie	
auye	auu	
west yugur	ybe	
kakwa	keo	
sa'ban	snv	
western frisian	fry	
gogodala	ggw	
ket	ket	
giiwo	kks	
teluti	tlt	
binukidnon	kyn	mtw	
pauserna	psm	
fur	fvr	
jiru	jrr	
wurrugu	wur	
cakfem-mushere	cky	
tabla	tnm	
zakhring	zkr	
kunimaipa	kup	
gaelic	ghc	gla	
kukatja	kux	
haruai	tmd	
isu (fako division)	szv	
kpagua	kuw	
medumba	byv	
bauzi	bvz	
maridan	zmd	
maltese sign language	mdl	
jordanian sign language	jos	
lawangan	lbx	
tagwana senoufo	tgw	
ci gbe	cib	
ukhrul	nmf	
biete	biu	
dibabawon manobo	mbd	
putoh	put	
fania	fni	
wasco-wishram	wac	
kankanaey	kne	
pamlico	pmk	
shi	shr	
aimele	ail	
gepo	ygp	
afghan sign language	afg	
bedawiyet	bej	
cori	cry	
achterhoeks	act	
southern pame	pmz	
ullatan	ull	
upper taromi	tov	
dusun	dtp	kzs	
khmer	khm	kxm	
nai	bio	
hanga hundi	wos	
ga'dang	gdg	
southern dong	kmc	
marghi central	mrt	
jiongnai bunu	pnu	
kumaoni	kfy
khiamniungan naga	kix	
agutaynen	agn	
kumbewaha	xks	
xaasongaxango	kao	
tsimshian	tsi	
nauete	nxa	
naha'ai	mlx	
bon gula	glc	
ashkun	ask	
yalarnnga	ylr	
minokok	mqq	
nauna	ncn	
ndai	gke	
macuiltianguis zapotec	zaa	
mwotlap	mlv	
pengo	peg	
silesian	sli	szl	
tehuelche	teh	
coahuilteco	xcw	
papitalai	pat	
mungkip	mpv	
bwatoo	bwa	
kushi	kuh	
romansh	roh	
dogri (macrolanguage)	doi	
kerewo	kxz	
ilongot	ilk	
hawai'i pidgin	hwc	
morawa	mze	
pije	piz	
võro	vro	
siri	sir	
ahanta	aha	
kigiryama	nyf	
binongan itneg	itb	
erokwanas	erw	
norwegian sign language	nsl	
teme	tdo	
urhobo	urh	
tigak	tgc	
stod bhoti	sbu	
kuk	kfn	
kuri	nbn	
pangasinan	pag	
hoyahoya	hhy	
ekegusii	guz	
sawai	szw	
safwa	sbk	
iwaidja	ibd	
isthmus zapotec	zai	
thiin	iin	
deori	der	
godwari	gdx	
shanga	sho	
standard malay	zsm	
santa maría zacatepec mixtec	mza	
guliguli	gli	
atsahuaca	atc	
vilela	vil	
estado de méxico otomi	ots	
texcatepec otomi	otx	
bambam	ptu	
siang	sya	
batak simalungun	bts	
mulgi	mvh	
southern kalinga	ksc	
intha	int	
purisimeño	puy	
adabe	adb	
cuba sign language	csf	
mesme	zim	
kamara	jmr	
east ambae	omb	
murupi	mqw	
skagit	ska	
wuzlam	udl	
semai	sea	
monsang naga	nmh	
marimanindji	zmm	
brokkat	bro	
dutch sign language	dse	
callawalla	caw	
queyu	qvy	
yola	yol	
mpoto	mpa	
kinaray-a	krj	
akpes	ibe	
wab	wab	
centúúm	cet	
western katu	kuf	
asoa	asv	
northern khmer	kxm	
canela	ram	
betaf	bfe	
sudanese arabic	apd	
northern altai	atv	
arin	xrn	
jakun	jak	
gungabula	gyf	
western karaboro	kza	
yangben	yav	
kopkaka	opk	
wemba wemba	xww	
kodeoha	vko	
uya	usu	
oblo	obl	
nobonob	gaw	
gupa-abawa	gpa	
kumbainggar	kgs	
sheshi kham	kip	
apasco-apoala mixtec	mip	
lanima	lnw	
amal	aad	
moabite	obm	
gilaki	glk	
selepet	spl	
ilianen manobo	mbi	
lasgerdi	lsa	
jimi (cameroon)	jim	
abanyom	abm	
northern kissi	kqs	
niuafo'ou	num	
torona	tqr	
upper saxon	sxu	
kela (papua new guinea)	kcl	
bubi	buw	
dar fur daju	daj	
mudhili gadaba	gau	
yaka (democratic republic of congo)	yaf	
bay miwok	mkq	
bakaka	bqz	
noon	snf	
tlhingan-hol	tlh	
gua	gwx	
lawunuia	tgi	
kaang chin	ckn	
deccan	dcc	
lavukaleve	lvk	
ot danum	otd	
jutish	jut	
tahitian	tah	
kaapor sign language	uks	
south picene	spx	
bidayuh	bth	sdo	sne	trx	
bashkir	bak	
wahau kayan	whu	
norwegian	nor	rmg	nob	
buyu	byi	
arabic	aao	abh	abv	acm	acq	acw	acx	acy	adf	aeb	aec	afb	ajp	ajt	aju	apc	apd	ara	arb	arq	ars	ary	arz	auz	avl	ayh	ayl	ayn	ayp	jye	shu	sqr	ssh	xaa	yhd	yud	
pagi	pgi	
zorop	wfg	
diuxi-tilantongo mixtec	xtd	
kgalagadi	xkv	
yala	yba	
belanda viri	bvi	
mao naga	nbi	
papapana	ppn	
ma (democratic republic of congo)	msj	
shihhi arabic	ssh	
engdewu	ngr	
russian sign language	rsl	
copainalá zoque	zoc	
irarutu	irh	
bodo parja	bdv	
central bontok	lbk	
silimo	wul	
apache	apj	apk	apl	apm	apw	
guayabero	guo	
belanda bor	bxb	
phala	ypa	
central berawan	zbc	
ghanongga	ghn	
dar sila daju	dau	
nyanga	nyj	
gulay	gvl	
tahltan	tht	
diebroud	tbp	
kalou	ywa	
aranda	axl	
atayal	tay	
hindko	hnd	hno	
chaudangsi	cdn	
rwa	rwk	
comecrudo	xcm	
sierra de juárez zapotec	zaa	
pankhu	pkh	
west makian	mqs	
dari	gbz	prs	
lolak	llq	
cappadocian greek	cpg	
montol	mtl	
bosnian	bos	
eastern karnic	ekc	
mangue	mom	
tzeltal	tzh	
santiago del estero quichua	qus	
nubi	kcn	
klias river kadazan	kqt	
panchpargania	tdb	
sama	slm	smd	sml	ssb	sse	
rinconada bikol	bto	
kango (tshopo district)	kzy	
sempan	xse	
jeh	jeh	
quileute	qui	
lakondê	lkd	
disa	dsi	
phangduwali	phw	
parkwa	pbi	
aimaq	aiq	
khezha naga	nkh	
natioro	nti	
sogdian	sog	
piaroa	pid	
tetela	tll	
notre	bly	
chukot	ckt	
ngkâlmpw kanum	kcd	
creole portuguese	mcm	vkp	
tsaukambo	kvz	
kupia	key	
ladino	lad	
mundang	mua	
botolan sambal	sbl	
aghul	agx	
middle cornish	cnx	
udi	udi	
dehu	dhv	
vera'a	vra	
anaang	anw	
kwama	kmq	
ligbi	lig	
ron	cla	
usku	ulf	
jaya	jyy	
supyire	spp	
tzotzil	tzo	
plateau malagasy	plt	
chaldean neo-aramaic	cld	
tidore	tvo	
soqotri	sqt	
kiembu	ebu	
blang	blr	
ijo	ijs	
benabena	bef	
tày sa pa	tys	
panawa	pwb	
lubila	kcc	
siraya	fos	
ukpe-bayobiri	ukp	
northern gondi	gno	
iowa-oto	iow	
badui	bac	
pini	pii	
kwaza	xwa	
sango	sag	snj	
kalapuya	kyl	nrt	sxk	
carolinian	cal	
yaygir	xya	
dahalik	dlk	
columbia-wenatchi	col	
orok	oaa	
agta	agk	agt	agz	apf	atl	dgc	due	dul	duo	duy	dyg	
nepali (macrolanguage)	nep	
maden	xmx	
akha	ahk	
nema	gsn	
yelogu	ylg	
upper chehalis	cjh	
cameroon mambila	mcu	
southern nago	nqg	
mpalitjanh	xpj	
ventureño	veo	
mag-antsi ayta	sgb	
golpa	lja	
santa maría quiegolani zapotec	zpi	
ha	haq	
nyâlayu	yly	
southeastern tarahumara	tcu	
masela	mss	mxz	vme	
mara chin	mrh	
nkhumbi	khu	
she	shx	
subiya	sbs	
kagoro	xkg	
kunigami	xug	
gyele	gyi	
yarluyandi	yry	
cheke holo	mrn	
guramalum	grz	
miqie	yiq	
pumpokol	xpm	
yucatec maya	yua	
ghodoberi	gdo	
southern tutchone	tce	
kis	kis	
nkami	nkq	
lyngngam	lyg	
old irish (to 900)	sga	
vunapu	vnp	
abaga	abg	
piscataway	psy	
kadaru	kdu	
hobyót	hoh	
wichita	wic	
yukuben	ybl	
southern pashto	pbt	
northern pumi	pmi	
creole hindi	hca	
suki	sui	
'auhelawa	kud	
pendau	ums	
awiyaana	auy	
kham	kgj	kif	kip	kjl	
scottish gaelic	gla	
masimasi	ism	
gone dau	goo	
ghanaian pidgin english	gpe	
dii	dur	
yiningayi	ygi	
nicaraguan sign language	ncs	
valley maidu	vmv	
tiruray	tiy	
japanese	jpn	ojp	
kuan	uan	
yace	ekr	
boko	bqc	
kakabai	kqf	
quechua	qub	que	quf	quh	quk	qul	qup	qur	qux	quy	quz	qva	qvc	qve	qvh	qvl	qvm	qvn	qvo	qvp	qvs	qvw	qwa	qwc	qwh	qws	qxa	qxc	qxh	qxn	qxo	qxp	qxt	qxu	qxw	
lumbee	lmz	
juang	jun	
sanaani arabic	ayn	
balkan romani	rmn	
cakchiquel	cak	
totontepec mixe	mto	
gyem	gye	
southern bai	bfs	
kwaami	ksq	
huehuetla tepehua	tee	
sabah malay	msi	
mandari	mqu	
swahili (individual language)	swh	
bangubangu	bnx	
gumatj	gnn	
soo	teu	
southern mnong	mnn	
dano	aso	
kawacha	kcb	
rongga	ror	
//ani	hnh	
gumalu	gmu	
phrae pwo karen	kjt	
andi	ani	
punthamara	xpt	
nhuwala	nhf	
tututni	tuu	
tanahmerah	tcm	
occitan (post 1500)	oci	
komba	kpf	
maldivian	div	
birrpayi	xbj	
picard	pcd	
hieroglyphic luwian	hlu	
kuskokwim	kuu	
wasembo	gsp	
harari	har	
french sign language	fsl	
dyugun	dyd	
dhimal	dhi	
mesopotamian arabic	acm	
kok borok	trp	
lyélé	lee	
frankish	frk	
kaingáng	zkp	
s.sofia d'epiro	aae	
ndo	ndp	
rang	rax	
tibea	ngy	
medebur	mjm	
lhokpu	lhp	
wanap	wnp	
ancient greek (to 1453)	grc	
long phuri naga	lpn	
andalusian arabic	xaa	
ghadamès	gha	
daga	dgz	
gurindji	gue
gurinji	gue
barí	mot	
arikara	ari	
achi	acr	
bagirmi fulfulde	fui	
tillamook	til	
tayabas ayta	ayy	
azha	aza	
tuscarora	tus	
lawu	lwu	
ugandan sign language	ugn	
ede ica	ica	
gan chinese	gan	
kplang	kph	
gangulu	gnl	
kutenai	kut	
yapunda	yev	
yukpa	yup	
mashco piro	cuj	
c'lela	dri	
sangir	sxn	
temascaltepec nahuatl	nhv	
sumerian	sux	
riang (myanmar)	ril	
severn ojibwa	ojs	
abadi	kbt	
paleni	pnl	
hu	huo	
kenswei nsei	ndb	
katawixi	xat	
ngasa	nsg	
biritai	bqq	
lao naga	nlq	
bushoong	buf	
gondi	esg	gno	gon	wsg	
chittagonian	ctg	
manide	abd	
maléku jaíka	gut	
malaccan creole malay	ccm	
libyan sign language	lbs	
emai-iuleha-ora	ema	
guianese creole french	gcr	
ogbronuagum	ogu	
barakai	baj	
mbongno	bgu	
wapishana	wap	
yidiny	yii	
langobardic	lng	
semnani	smy	
nocamán	nom	
musar	mmi	
gilima	gix	
pattani malay	mfa	
tsakonian	tsd	
southwest pashayi	psh	
manda (australia)	zma	
bukat	bvk	
somray	smu	
javanese	jas	jav	jvn	
rakahanga-manihiki	rkh	
latgalian	ltg	
teshenawa	twc	
majukayang kalinga	kmd	
watiwa	wtf	
pochutec	xpo	
tiv	tiv	
logba	lgq	
chochotec	coz	
pintiini	pti	
gitua	ggt	
daakaka	bpa	
pisidian	xps	
baetora	btr	
kwaja	kdz	
saweru	swr	
pakanha	pkn	
shahmirzadi	srz	
tlingit	tli	
avar	oav	ava
umbrian	xum	
geme	geq	
taznatit	grr	
kein	bmh	
cia-cia	cia	
umbuygamu	umg	
karkin	krb	
yongkom	yon	
tarpia	tpf	
akuku	ayk	
wulna	wux	
curripaco	kpc	
mal paharia	mkb	
hibito	hib	
venezuelan sign language	vsl	
serua	srw	
southwestern fars	fay	
baatonum	bba	
gedeo	drs	
mokerang	mft	
leipon	lek	
berbice creole dutch	brc	
dadiya	dbd	
cacgia roglai	roc	
west damar	drn	
lusitanian	xls	
lahnda	lah	
kohistani	mvy	
maa	cma	
lai	cnh	
ngiti	niy	
waima	rro	
shona	sna	
wiradhuri	wrh	
onondaga	ono	
perai	wet	
moyadan itneg	ity	
mixtepec zapotec	zpm	
san dionisio del mar huave	hve	
suena	sue	
kayupulau	kzu	
bati (cameroon)	btc	
havu	hav	
kami (nigeria)	kmi	
mariri	mqi	
sagala	sbm	
achang	acn	
kinnauri	cik	kfk	kjo	nes	
mewati	wtm	
tungag	lcm	
aluo	yna	
oy	oyb	
kungarakany	ggk	
dagik	dec	
athpariya	aph	
asturian	ast	
tukudede	tkd	
nora	nrr	
casiguran dumagat agta	dgc	
zire	sih	
peranakan indonesian	pea	
guarayu	gyr	
santa lucía monteverde mixtec	mdv	
bakairí	bkq	
ningil	niz	
kitja	gia	
djadjawurrung	dja	
pahari-potwari	phr	
dibole	bvx	
olumarachi	lri	
batanga	bnm	
south central dinka	dib	
phrygian	xpg	
patani	ptn	
aragonese	arg	
sibu melanau	sdx	
tainae	ago	
anufo	cko
uvean	uve	
mandingo	man	
bengali	ben	
kobon	kpw	
lubukusu	bxk	
mazanderani	mzn	
patwin	pwi	
polnisch	pol	
piemontese	pms	
puragi	pru	
dirim	dir	
liki	lio	
bandi	bza	
busuu	bju	
blafe	bfh	
kuanua	ksd	
manyika	mxc	
azhe	yiz	
upper guinea crioulo	pov	
yela	yel	
nukna	klt	
labu	lbu	
bazigar	bfr	
old frisian	ofs	
sambalpuri	spv	
wagi	fad	
sota kanum	krz	
apatani	apt	
hadrami arabic	ayh	
hakha chin	cnh	
kuke	ght	
tutuba	tmi	
greek	cpg	ell	gmy	grc	
yoke	yki	
mbule	mlb	
pimbwe	piw	
akpa	akf	
nyangga	nny	
bantoanon	bno	
unserdeutsch	uln	
sumtu chin	csv	
coeur d'alene	crd	
copala triqui	trc	
eastern bontok	ebk	
san martín itunyoso triqui	trq	
dida	dic	gud	
mudu koraga	vmd	
emberá-chamí	cmi	
breri	brq	
northern catanduanes bikol	cts	
qashqa'i	qxq	
ahom	aho	
thangmi	thf	
squliq	tay	
highland puebla nahuatl	azz	
haeke	aek	
calderón highland quichua	qud	
paekche	pkc	
mbowe	mxo	
yamdena	jmd	
gugu badhun	gdc	
serbocroatian	srp	
komering	kge	
guyanese creole english	gyn	
volscian	xvo	
segeju	seg	
dza	jen	
tebi	dmu	
ayiwo	nfl	
manumanaw karen	kxf	
shabak	sdb	
romany	rom	
zou	zom	
kirikiri	kiy	
haisla	has	
wolaitta	wal	
saparua	spr	
palaka senoufo	plr	
khoekhoe	naq	
babanki	bbk	
arrarnta	are	
san juan teita mixtec	xtj	
badiotto	lld	
lipan apache	apl	
arpitan	frp	
seta	stf	
binumarien	bjr	
eastern magar	mgp	
teke	tek	
duli-gey	duz	
djeebbana	djj	
western cham	cja	
northern sierra miwok	nsq	
el hugeirat	elh	
tboli	tbl	
kamba (kenya)	kam	
mbosi	mdw	
lishán didán	trg	
tajiki arabic	abh	
bukusu	bxk	
german sign language	gsg	
rutul	rut	
catalan sign language	csc	
tonjon	tjn	
mandar	mdr	
nachering	ncd	
bandial	bqj	
esan	ish	
washo	was	
artificial language	*xx	
cajun french	frc	
ligurian	lij	
alviri-vidari	avd	
baure	brg	
izii	izz	
tewa (usa)	tew	
samburu	saq	
yangulam	ynl	
jola-kasa	csk	
havasupai-walapai-yavapai	yuf	
seeku	sos	
luba-lulua	lua	
tabo	knv	
lobu	low	ruu	
udihe	ude	
balanta-ganja	bjt	
gunditjmara	gjm	
teke-tyee	tyx	
old marathi	omr	
bolgarian	xbo	
changthang	cna	
udmurt	udm	
ghulfan	ghl	
taabwa	tap	
mongolian sign language	msr	
arabela	arl	
balanta-kentohe	ble	
mom jango	ver	
nandi	niq	
kadai	kzd	
ndobo	ndw	
cun	cuq	
pana (burkina faso)	pnq	
martha's vineyard sign language	mre	
sawknah	swn	
chimalapa zoque	zoh	
orizaba nahuatl	nlv	
shwai	shw	
kolyma yukaghir	yux	
dia	dia	
sara kaba deme	kwg	
southern muji	ymc	
argentine sign language	aed	
upper ta'oih	tth	
helambu sherpa	scp	
zimba	zmb	
dagaari dioula	dgd	
bimoba	bim	
sasaru	sxs	
beba	bfp	
kisan	xis	
gronings	gos	
lelepa	lpa	
siarlak	sjr	
kui (indonesia)	kvd	
hellenistic greek	grc	
nkutu	nkw	
wára	tci	
uruguayan sign language	ugy	
antigua and barbuda creole english	aig	
cogui	kog	
wolof	wof	wol	
samo	sbd	smq	stj	sym	
limburgish	lim	
iyo'wujwa chorote	crq	
wikngenchera	wua	
v'ënen taut	nmb	
temacine tamazight	tjo	
tupuri	tui	
arabana	ard	
tamajaq	ttq	
nuaulu	nni	nxl	
pogolo	poy	
selaru	slu	
boro (ghana)	xxb	
bafanji	bfj	
kryts	kry	
tacahua mixtec	xtt	
panjabi	pan	pnb	
amarasi	aaz	
beezen	bnz	
garasia	gas	gra	
boon	bnl	
guambiano	gum	
xingú asuriní	asn	
lukabaras	lkb	
tunebo	tbn	tnb	tnd	tuf	
assyrian neo-aramaic	aii	
epi-olmec	xep	
mamusi	kdf	
minjungbal	xjb	
yinbaw karen	kvu	
western parbate kham	kjl	
kwinti	kww	
mindiri	mpn	
mitlatongo mixtec	vmm	
sengo	spk	
cherokee	chr	
sentinel	std	
sangu (tanzania)	sbp	
namiae	nvm	
malol	mbk	
momina	mmb	
north efate	llp	
zenzontepec chatino	czn	
yalálag zapotec	zpu	
ake	aik	
zeme naga	nzm	
tututepec mixtec	mtu	
lahu	lhu	
raji	rji	
birwa	brl	
east makian	mky	
official aramaic (700-300 bce)	arc	
ayutla mixtec	miy	
central mashan hmong	hmm	
kwanja	knp	
sarsi	srs	
awak	awo	
bobongko	bgb	
masiwang	bnf	
arem	aem	
ayangan ifugao	ifb	
lushai	lus	
muya	mvm	
selayar	sly	
bolongan	blj	
khana	ogo	
doutai	tds	
ainu	ain	
maltese	mlt	
northern kankanay	xnn	
western highland purepecha	pua	
júma	jua	
doka	dbi	
duriankere	dbn	
manx	glv	
kombai	tyn	
ewondo	ewo	
kpan	kpk	
miao	cqd	hea	hma	hmc	hmd	hme	hmh	hmi	hml	hmm	hmp	hmq	hms	hmw	hmy	hmz	hrm	huj	mmr	muq	sfm	
sanie	ysy	
german	deu	gct	geh	gmh	gml	goh	gsw	nds	pdc	
edolo	etr	
owa	stn	
yauyos quechua	qux	
anserma	ans	
tagbu	tbm	
yine	pib	
mayangna	yan	
sentani	set	
salumá	slj	
mabaka valley kalinga	kkg	
virgin islands creole english	vic	
beothuk	bue	
engenni	enn	
ontong java	ojv	
efe	efe	
lango (sudan)	lno	
gela	nlg	
bahnar	bdq	
southern bontok	obk	
mbo (cameroon)	mbo	
kande	kbs	
ede idaca	idd	
sambe	xab	
maca	mca	
pashayi	aee	glh	psh	psi	
kuijau	dkr	
capiznon	cps	
latvian	lav	lvs	
ngas	anc	
chinese pidgin english	cpi	
kumba	ksm	
southern binukidnon	mtw	
chuang	zha	
idoma	idu	
yagwoia	ygw	
lhaovo	mhx	
aheu	thm	
gayo	gay	
avau	avb
southwestern huishui hmong	hmh	
nyindrou	lid	
kinuku	kkd	
nasarian	nvh	
gagu	ggu	
tiene	tii	
san martín quechua	qvs	
awutu	afu	
chichonyi-chidzihana-chikauma	coh	
sursurunga	sgz	
soi	soj	
ulch	ulc	
nyaw	nyw	
jair awyu	awv	
classical newari	nwc	
yawijibaya	jbw	
tamki	tax	
old persian (ca. 600-400 b.c.)	peo	
neo	neu	
lushootseed	lut	
damakawa	dam	
buwal	bhs	
sunam	ssk	
longto	wok	
bualkhaw chin	cbl	
luhu	lcq	
cowlitz	cow	
vale	vae	
chepya	ycp	
taveta	tvs	
dugun	ndu	
tobanga	tng	
zazaki	zza	diq	kiu	
mangerr	zme	
dimli (macrolanguage)	zza	
bogaya	boq	
old breton	obt	
ndasa	nda	
barababaraba	rbp	
//gana	gnk	
sani	ysn	
ghotuo	aaa	
tondi songway kiini	tst	
serbian (srp) + croatian (hrv) + bosnian	bos	
wadjiginy	wdj	
damal	uhn	
kwese	kws	
apurinã	apu	
kachari	xac	
konjo	kjc	kjk	
bodo (india)	brx	
weri	wer	
thakali	ths	
ogbogolo	ogg	
kuku-mu'inh	xmp	
silopi	xsp	
vemgo-mabas	vem	
koke	kou	
kpasam	pbn	
manado malay	xmm	
huba	hbb	
ngete	nnn	
somrai	sor	
deng	mhu	mxj	
sika	ski	
wom (nigeria)	wom	
arhâ	aqr	
waneci	wne	
kepkiriwát	kpn	
como karim	cfg	
meohang	emg	raf	
yavitero	yvt	
nimoa	nmw	
ika	ikk	
amuzgo	amu	azg	azm	
sivandi	siy	
pochuri naga	npo	
leco	lec	
amanayé	ama	
balti	bft	
barasana-eduria	bsn	
chadong	cdy	
bolango	bld	
quebec french	fra	
western mashan hmong	hmw	
kofa	kso	
catalan	cat	
khinalugh	kjj	
assan	xss	
kalispel-pend d'oreille	fla	
yugur	ybe	yuy	
hungarian	hun	ohu	
nukuini	nuc	
temein	teq	
baga manduri	bmd	
/gwi	gwj	
pontic	pnt	
holu	hol	
wantoat	wnc	
sengele	szg	
molengue	bxc	
dusun malang	duq	
moresada	msx	
guaraní	gnw	gug	gui	gun	nhd	
mai brat	ayz	
wampur	waz	
lenje	leh	
koli	gjk	kvx	kxp	
nsenga	nse	
vanuma	vau	
santa teresa cora	cok	
shan	shn	
semelai	sza	
culina	cul	
cuiba	cui	
gangte	gnb	
mokilese	mkj	
sedoa	tvw	
ma'ya	slz	
kombio	xbi	
tol	jic	
emberá-baudó	bdc	
babuza	bzg	
islander creole english	icr	
akoose	bss	
kwakiutl	kwk	
idakho-isukha-tiriki	ida	
southern ghale	ghe	
laal	gdm	
venetian	vec	
bondoukou kulango	kzc	
gokana	gkn	
umanakaina	gdn	
enwan (akwa ibom state)	enw	
zeem	zua	
ngumbi	nui	
tai do	tyj	
kodaku	ksz	
bambassi	myf	
keningau murut	kxi	
téén	lor	
zyphe chin	zyp	
gresi	grs	
bassari	bsc	
sudest	tgo	
latin	lat	
punan merah	puf	
standard latvian	lvs	
chipewyan	chp	
mbandja	zmz	
yocoboué dida	gud	
birhor	biy	
jehai	jhi	
letemboi	nms	
western panjabi	pnb	
namibian sign language	nbs	
mendalam kayan	xkd	
alcozauca mixtec	xta	
mobumrin aizi	ahm	
sipacapense	qum	
rajasthani	raj	
nyong	muo	
maidu	mjd	nmu	vmv	
manambu	mle	
muria	emu	fmu	mut	
transalpine gaulish	xtg	
alor	aol	
yangum mon	ymo	
penan	pez	pne	
anem	anz	
tsaangi	tsa	
jilim	jil	
ikposo	kpo	
panao huánuco quechua	qxh	
melpa	med	
basa (nigeria)	bzw	
atorada	aox	
loja highland quichua	qvj	
swiss german	gsw	
southern thai	sou	
tariana	tae	
chipaya	cap	
sabaot	spy	
saep	spd	
molmo one	aun	
tommo so dogon	dto	
burmbar	vrt	
hun-saare	dud	
campalagian	cml	
siane	snp	
syenara senoufo	shz	
tongan	ton	
hmong daw	mww	
manding	man	
hoia hoia	hhi	
ndut	ndv	
dima	jma	
saisiyat	xsy	
gamale kham	kgj	
olulumo-ikom	iko	
fembe	agl	
squamish	squ	
labrador inuttut	ike	
napo lowland quechua	qvo	
sikule	skh	
bolondo	bzm	
awu	yiu	
ancient aramaic (up to 700 bce)	oar	
dompo	doy	
uhami	uha	
creole	afs	ccd	hat	lou	tcs	
singa	sgm	
red gelao	gir	
bu-nao bunu	bwx	
simaa	sie	
judeo-iraqi arabic	yhd	
dura	drq	
ligenza	lgz	
lufu	ldq	
makhuwa	vmw	
nabi	mty	
ejamat	eja	
saraiki	skr	
wumboko	bqm	
takwane	tke	
karkar-yuri	yuj	
tojolabal	toj	
qatabanian	xqt	
dimili	zza	
bata	bta	
cumanagoto	cuo	
takia	tbc	
papantla totonac	top	
navut	nsw	
hote	hot	
sur	tdl	
lolopo	ycl	ysp	
kalabari	ijn	
occidental	ile	
enya	gey	
isekiri	its	
newar	nwx	
dumpas	dmv	
sheko	she	
wariyangga	wri	
haveke	hvk	
lamatuka	lmq	
tera	ttr	
greenlandic	kal	
bharia	bha	
toposa	toq	
jiwarli	mem	
hyam	jab	
wamas	wmc	
cholón	cht	
igo	ahl	
semandang	sdm	
seba	kdg	
chicomuceltec	cob	
old tibetan	otb	
mpur	akc	
omok	omk	
camsá	kbh	
chinbon chin	cnb	
kioko	ues	
wersing	kvw	
kalarko	kba	
arigidi	aqg	
classical armenian	xcl	
mangga buang	mmo	
tsotsitaal	fly	
umpqua	xup	
pele-ata	ata	
north wahgi	whg	
wawa	www	
uyghur	uig	
phake	phk	
talieng	tdf	
au	avt	
pwo eastern karen	kjp	
caac	msq	
vasavi	vas	
kurrama	vku	
iteri	itr	
majhi	mjz	
bahonsuai	bsu	
hakö	hao	
akkala sami	sia	
gofa	gof	
chigmecatitlán mixtec	mii	
kurnai	unn	
mailu	mgu	
aeka	aez	
dixon reef	dix	
cusco quechua	quz	
chané	caj	
kistane	gru	
kamviri	xvi	
quebec sign language	fcs	
san juan guelavía zapotec	zab	
torricelli	tei	
wuding-luquan yi	ywq	
limburger	lim	
niellim	nie	
meru	mer	
yatzachi zapotec	zav	
villa viciosa agta	dyg	
krevinian	zkv	
phunoi	pho	
aka-kora	ack	
tokano	zuh	
mandarin	cmn	
shor	cjs	
mundani	mnf	
sepedi	nso	
khayo	lko	
tartessian	txr	
slovenian	slv	
tok pisin	tpi	
yau (morobe province)	yuw	
bussa	dox	
limi	ylm	
eruwa	erh	
awjilah	auj	
central huishui hmong	hmc	
bella coola	blc	
yotti	yot	
patpatar	gfk	
surubu	sde	
worimi	kda	
sena	seh	swk	
puquina	puq	
u	uuu	
a'tong	aot	
llengua de signes valenciana	vsv	
southern yamphu	lrr	
chemakum	xch	
southwest palawano	plv	
old nubian	onw	
tairaha	bxa	
kaki ae	tbd	
ossetic	oos	oss	
adyghe	ady	
comaltepec chinantec	cco	
arammba	stk	
penang sign language	psg	
playero	gob	
dobu	dob	
tamazola mixtec	vmx	
yintale karen	kvy	
trumai	tpy	
worodougou	jud	
doso	dol	
sorsogon ayta	ays	
kyenele	kql	
mankanya	knf	
tamashek	tmh	
tunica	tun	
miju-mishmi	mxj	
bukar-sadung bidayuh	sdo	
uisai	uis	
mid-southern banda	bjo	
israeli sign language	isr	
guana (paraguay)	gva	
khunsari	kfm	
lombo	loo	
fon	fon	
bassa	bsq	
yanomámi	wca	
lingao	onb	
kaduo	ktp	
womo	wmx	
bassa-kontagora	bsr	
sangisari	sgr	
naba	mne	
dai zhuang	zhd	
east damar	dmr	
selee	snw	
makah	myh	
sened	sds	
bubia	bbx	
murik (papua new guinea)	mtf	
lafofa	laf	
punan batu 1	pnm	
ancient hebrew	hbo	
comorian	swb	wlc	wni	zdj	
khün	kkh	
batak toba	bbc	
esperanto	epo	
kemak	kem	
dazaga	dzg	
ndyuka-trio pidgin	njt	
seraiki	skr	
gbesi gbe	gbs	
dharumbal	xgm	
ten'edn	tnz	
moba	mfq	
kathoriya tharu	tkt	
tulu	tcy	
seget	sbg	
southern nambikuára	nab	
rara bakati'	lra	
migabac	mpp	
fa d'ambu	fab	
okodia	okd	
gorovu	grq	
old mon	omx	
ihievbe	ihi	
waboda	kmx	
north azerbaijani	azj	
kajali	xkj	
kalanga	kck	
molof	msl	
pahlavani	phv	
pampanga	pam	
montagnais	moe	
yangum dey	yde	
bini	bin	
afghan persian	prs	
mescalero-chiricahua apache	apm	
bolyu	ply	
mehináku	mmh	
chitwania tharu	the	
tundra enets	enh	
serer	srr	
miriwoong sign language	rsm	
south levantine arabic	ajp	
djiwarli	dze	
el alto zapotec	zpp	
al-sayyid bedouin sign language	syy	
kharia	khr	
kalabakan	kve	
polish	pol	
ibali teke	tek	
jumjum	jum	
minaveha	mvn	
quinault	qun	
kui (india)	kxu	
pelende	ppp	
shabo	sbf	
nde-nsele-nta	ndd	
dangaléat	daa	
southern mashan hmong	hma	
yeniche	yec	
arapesh	aah	aon	
yongbei zhuang	zyb	
guadeloupean creole french	gcf	
kir-balar	kkr	
kayeli	kzl	
wutung	wut	
suku	sub	
ngbandi	nbw	ngb	
dem	dem	
libido	liq	
old spanish	osp	
fasu	faa	
teke-laali	lli	
migaama	mmy	
murut	kxi	mvv	tih	
rombo	rof	
emumu	enr	
southern luri	luz	
mozarabic	mxi	
southeast pashayi	psi	
banda-ndélé	bfl	
nivaclé	cag	
wardandi	wxw	
pinigura	pnv	
friulian	fur	
warembori	wsa	
uncoded languages	mis	
ukwuani-aboh-ndoni	ukw	
jicarilla apache	apj	
abu' arapesh	aah	
doghoro	dgx	
belhare	byw	
thompson	thp	
yidgha	ydg	
drung	duu	
mariyedi	zmy	
sulka	sua	
southern birifor	biv	
lewo eleng	lwe	
olekha	ole	
waimiri-atroari	atr	
niksek	gbe	
northern pomo	pej	
yutanduchi mixtec	mab	
masbatenyo	msb	
abellen ayta	abp	
nzakara	nzk	
fayu	fau	
isthmus-cosoleacaque nahuatl	nhk	
norn	nrn	
kwanga	kwj	
eyak	eya	
yareni zapotec	zae	
yinhawangka	ywg	
mezontla popoloca	pbe	
baba malay	mbf	
imbabura highland quichua	qvi	
ngundu	nue	
kiliwa	klb	
lukpa	dop	
zo'é	pto	
zanaki	zak	
yuki	yuk	
machinga	mvw	
mayo	mfy	
yup'ik	esu	
domu	dof	
ju	juu	
luna	luj	
mamvu	mdi	
kanufi	kni	
modern greek (1453-)	ell	
kâte	kmg	
miu	mpo	
bunak	bfn	
arhö	aok	
susuami	ssu	
keoru-ahia	xeu	
gavar	gou	
tatuyo	tav	
agarabi	agd	
kachi koli	gjk	
aymara	ayc	aym	ayr	
lakon	lkn	
rufiji	rui	
batak alas-kluet	btz	
ainu (japan)	ain	
bhoti kinnauri	nes	
phimbi	phm	
nimboran	nir	
mt. iriga agta	agz	
apalaí	apy
apalai	apy
selian	sxl	
beli (sudan)	blm	
amganad ifugao	ifa	
uyajitaya	duk	
dhofari arabic	adf	
yucateco	yua	
dela-oenale	row	
olu'bo	lul	
miya	mkf	
southern haida	hax	
aruá (rodonia state)	arx	
seselwa creole french	crs	
mountain koiali	kpx	
yopno	yut	
sabah bisaya	bsy	
anong	nun	
ambele	ael	
singpho	sgp	
koitabu	kqi	
dũya	ldb	
enwan (edu state)	env	
yendang	ynq	
maasina fulfulde	ffm	
aushi	auh	
nafaanra	nfr	
sop	urw	
tandia	tni	
fanagalo	fng	
haryanvi	bgc	
parkari koli	kvx	
karankawa	zkk	
yankunytjatjara	kdd	
tobati	tti	
balangingi	sse	
dawida	dav	
jamiltepec mixtec	mxt	
ninde	mwi	
amoltepec mixtec	mbz	
otank	uta	
bandjalang	bdy	
forak	frq	
alamblak	amp	
da-hua miao	hmd	
kuku-muminh	xmh	
nyang'i	nyp	
sumbwa	suw	
saruga	sra	
turkana	tuv	
roglai	rgs	roc	rog	
undetermined	und	
bulu (papua new guinea)	bjl	
drehu	dhv	
labo	mwi	
mauritian	mfe	
pumé	yae	
fuliiru	flr	
tarao naga	tro	
dao	daz	
lule sami	smj	
maewo	mwo	
sembakung murut	sbr	
mansoanka	msw	
yangkam	bsx	
russian	orv	rus	
kamayo	kyk	
yeni	yei	
yug	yug	
bwa	bww	
zerenkel	zrn	
iguta	nar	
mbulungish	mbv	
angal heneng	akh	
logudorese sardinian	src	
masalit	mls	
adangbe	adq	
manta	myg	
neo-aramaic	aii	amw	bhn	bjf	cld	
kissi	kqs	
areba	aea	
baga sitemu	bsp	
kyan-karyaw naga	nqq	
loma (côte d'ivoire)	loi	
langam	lnm	
tanana	taa	tau	
middle french (ca. 1400-1600)	frm	
aighon	aix	
anmatyerre	amx	
mbuko	mqb	
bhele	bhy	
sekapan	skp	
singapore sign language	sls	
tangkhul naga (india)	nmf	
ethiopian sign language	eth	
hassaniyya	mey	
samaritan aramaic	sam	
kibiri	prm	
konyak naga	nbe	
nupbikha	npb	
iban	iba	
liuqian zhuang	zlq	
rampi	lje	
miskitu	miq	
sapuan	spu	
ngan'gityemerri	nam	
dai	dij	
southeast pashai	psi	
yandjibara	xyb	
nasu	yig	ywu	
eskayan	esy	
emberá	emp	
wanukaka	wnk	
mru	mro	
heiban	hbn	
hunzib	huz	
nyam	nmi	
nawathinehena	nwa	
bhojpuri	bho	
malba birifor	bfo	
ikulu	ikl	
nabak	naf	
mentawai	mwv	
saraveca	sar	
guya	gka	
leningitij	lnj	
vili	vif	
angal enen	aoe	
kulango	kzc	nku	
kalami	gwc	
angor	agg	
chuave	cjv	
twents	twd	
nomane	nof	
nigerian pidgin	pcm	
mwera (chimwera)	mwe	
molale	mbe	
pite sami	sje	
kudiya	kfg	
khumi chin	cnk	
ndoe	nbb	
sansi	ssi	
gusilay	gsl	
cara	cfd	
teanu	tkw	
southeast ambrym	tvk	
pare	ppt	
estonian	ekk	est	
nggem	nbq	
chara	cra	
suwawa	swu	
mabaan	mfz	
hõne	juh	
nuosu	iii	
nepal bhasa	new	nwc	
daro-matu melanau	dro	
zemgalian	xzm	
ketangalan	kae	
northeastern thai	tts	
sori-harengan	sbh	
phoenician	phn	
kara (central african republic)	kah	
akoye	miw	
palaung	pce	pll	rbb	
woiwurrung	wyi	
gidar	gid	
old russian	orv	
inuktitut	ike	ikt	iku	kal	
zaza	zza	
huastec	hus	
qimant	ahg	
toba-maskoy	tmf	
idi	idi	
ponam	ncc	
avatime	avn	
tonga (tonga islands)	ton	
baluchi	bal	
chong	cog	
tai dam	blt	
bwaidoka	bwd	
muyang	muy	
bugawac	buk	
djambarrpuyngu	djr	
dyangadi	dyn	
omurano	omu	
tauya	tya	
bajau	bdl	bdr	
noric	nrc	
highland popoluca	poi	
central yupik	esu	
tawala	tbo	
wiraféd	wir	
british sign language	bfi	
mese	mci	
san baltazar loxicha zapotec	zpx	
djawi	djw	
yimas	yee	
magoma	gmx	
atikamekw	atj	
north mofu	mfk	
walak	wlw	
samba	smx	
thado chin	tcz	
afade	aal	
ndaktup	ncp	
befang	bby	
eastern keres	kee	
eastern karaboro	xrb	
boga	bvw	
tày tac	tyt	
dinka	dib	dik	din	dip	diw	dks	
atohwaim	aqm	
nhengatu	yrl	
kube	kgf	
macedonian	mkd	xmk	
urak lawoi'	urk	
abinomn	bsa	
eastern huasteca nahuatl	nhe	
tiemacèwè bozo	boo	
haroti	hoj	
kanu	khx	
kabiyè	kbp	
modole	mqo	
sri lankan creole malay	sci	
ndolo	ndl	
bola	bnp	
dumi	dus	
animere	anf	
orma	orc	
jeri kuo	jek	
sangkong	sgk	
tulishi	tey	
hebrew	hbo	heb	
ngangam	gng	
huautla mazatec	mau	
rapa	ray	
djinang	dji	
iku-gora-ankwa	ikv	
maring naga	nng	
hlepho phowa	yhl	
tedim chin	ctd	
ayoreo	ayo	
eastern xiangxi miao	muq	
taino	tnq	
tumzabt	mzb	
ding	diz	
labo phowa	ypb	
korandje	kcy	
kalanguya	kak	
lotud	dtr	
kriol english	bzj	
bonjo	bok	
manumanaw	kxf	
ojibwa	ojb	ojc	ojg	oji	ojs	ojw	otw	
phende	pem	
ecuadorian sign language	ecs	
lalo	yik	ywt	
chiduruma	dug	
caluyanun	clu	
minz zhuang	zgm	
nyaheun	nev	
mba	mfc	
bookan	bnb	
urningangg	urc	
midob	mei	
basa-gumna	bsl	
moyon naga	nmo	
elu	elu	
murui huitoto	huu	
bikol	bcl	bik	bln	bto	cts	fbl	lbl	rbl	ubl	
gabi-gabi	gbw	
tosk albanian	als	
huli	hui	
khisa	kqm	
kisankasa	kqh	
southeastern tepehuan	stp	
temoq	tmo	
siar-lak	sjr	
moken	mwt	
soli	sby	
yauma	yax	
zialo	zil	
mari (madang province)	hob	
gavak	dmc	
kenyah	whk	
northwestern fars	faz	
bura-pabir	bwr	
pame	pbs	pmq	pmz	
dusner	dsn	
manya	mzj	
northwestern kolami	kfb	
garre	gex	
wandala	mfi	
turka	tuz	
haida	hai	hax	hdn	
dongxiang	sce	
carrier	caf	crx	
upper umpqua	xup	
lozi	loz	
pitta pitta	pit	
mbudum	xmd	
dhangu	dhg	
koro (india)	jkr	
sara kaba	sbz	
pidgin delaware	dep	
kwami	ktf	
binahari	bxz	
oneida	one	
lamet	lbn	
teke-tege	teg	
loko	lok	
casuarina coast asmat	asc	
chenchu	cde	
kim mun	mji	
pirlatapa	bxi	
podena	pdn	
luchazi	lch	
port sandwich	psw	
kaskean	zsk	
domung	dev	
oroch	oac	
edopi	dbf	
mongolian	cmg	khk	mon	mvf	xng	
morouas	mrp	
rusyn	rue	
kintaq	knq	
itonama	ito	
peruvian sign language	prl	
lahanan	lhn	
ede nago	nqk	
wanggom	wng	
oscan	osc	
nayini	nyq	
molima	mox	
fwâi	fwa	
keliko	kbo	
bo-ung	mux	
wichí lhamtés vejoz	wlv	
chichewa	nya	
kenyang	ken	
kwerba mamberamo	xwr	
mugom	muk	
konda	knd	
kungkari	lku	
bishnupriya	bpy	
boloki	bkt	
tuwali ifugao	ifk	
kompane	kvp	
middle dutch	dum
santiago xanica zapotec	zpr	
kanan	zkn	
mazatec	maa	maj	maq	mau	mzi	vmp	vmy	vmz	
kangean	kkv	
peere	pfe	
wolane	wle	
pela	bxd	
foodo	fod	
asho chin	csh	
kayan river kayan	xkn	
guiberoua béte	bet	
mada (cameroon)	mxu	
ogea	eri	
makasae	mkz	
lendu	led	
angaité	aqt	
tseku	tsk	
fwe	fwe	
luxembourgish	ltz	
batu	btu	
kwerisa	kkb	
nahali	nlx	
west ambae	nnd	
old saxon	osx	
nomu	noh	
coatlán zapotec	zps	
sinicized miao	hmz	
surgujia	sgj	
tereno	ter	
gimme	kmp	
lahul lohar	lhl	
dera (indonesia)	kbv	
dubli	dub	
buli	bwu	
dagba	dgk	
namonuito	nmt	
nanticoke	nnt	
kadazan dusun	dtp	
surigaonon	sgd	
gonja	gjn	
central ojibwa	ojc	
riantana	ran	
nila	nil	
nadëb	mbj	
yaur	jau	
krahô	xra	
middle korean (10th-16th cent.)	okm	
ivatan	ivv	
mokole	mkl	
puelche	pue	
langue des signes de belgique francophone	sfb	
bikaru	bic	
wik-mungkan	wim	
ngiemboon	nnh	
suruahá	swx	
viemo	vig	
shanenawa	swo	
sari	asj	
san dionicio ocotepec zapotec	ztu	
western ojibwa	ojw	
usaghade	usk	
liburnian	xli	
north marquesan	mrq	
samei	smh	
lalia	lal	
colonial valley zapotec	zap	
noy	noy	
northwestern dinka	diw	
ekajuk	eka	
triqui	trc	trq	trs	
mesaka	iyo	
yurok	yur	
me'phaa	tcf	tpc	tpl	tpx	
tataltepec chatino	cta	
ida'an	dbj	
dyaberdyaber	dyb	
aheri gondi	esg	
sankaran maninka	msc	
sambal	sbl	xsb	
saek	skb	
wandji	wdd	
sugut dusun	kzs	
malapandaram	mjp	
seri	sei	
kajakse	ckq	
papuan malay	pmy	
middle high german (ca. 1050-1500)	gmh	
itundujia mixtec	mce	
maskelynes	klv	
wanyi	wny	
päri	lkr	
hunjara-kaina ke	hkk	
basay	byq	
jaunsari	jns	
ratahan	rth	
chinese sign language	csl	
talise	tlr	
odual	odu	
kenga	kyq	
maslam	msv	
obulom	obu	
rakhine	rki	
sakalava malagasy	skg	
wadikali	wdk	
kaburi	uka	
degaru	dgu	
hoti	hti	
mararit	mgb	
ajyíninka apurucayali	cpc	
khoibu naga	nkb	
aore	aor	
malavedan	mjr	
ahtena	aht	
güilá zapotec	ztu	
kabola	klz	
nyahkur	cbn	
cacua	cbv	
tiale	mnl	
uighur	oui	uig	
wotu	wtw	
khamti	kht	
bokha	ybk	
rerep	pgk	
koneraw	kdw	
phuza	ypz	
walio	wla	
edo	bin	
seluwasan	sws	
bhatri	bgw	
dakka	dkk	
new caledonian javanese	jas	
biga	bhc	
wumeng nasu	ywu	
pyu (papua new guinea)	pby	
subtiaba	sut	
masadiit itneg	tis	
southern ngbandi	nbw	
jarawa (india)	anq	
worrorra	wro	
kikuyu	kik	
bentong	bnu	
konomala	koa	
oluta popoluca	plo	
mano	mev	
achagua	aca	
ladin	lld	
southwestern tarahumara	twr	
sala	shq	
pacific gulf yupik	ems	
lotha naga	njh	
foia foia	ffi	
tiang	tbj	
wa	wbm	
alta	agy	aqn	
ulumanda'	ulm	
tlacoapa tlapanec	tpl	
yulu	yul	
bru	bru	brv	
ari	aac	
puerto rican sign language	psl	
salvadoran sign language	esn	
nimadi	noe	
kagayanen	cgc	
mullukmulluk	mpb	
tumak	tmc	
kang	kyp	
tsogo	tsv	
bongu	bpu	
wayoró	wyr	
senara sénoufo	seq	
northwest alaska inupiatun	esk	
low german	nds	
bongo	bot	
malfaxal	mlx	
omotik	omt	
logol	lof	
yipma	byr	
pana (central african republic)	pnz	
elfdalian	ovd	
mondropolon	npn	
northern puebla nahuatl	ncj	
romkun	rmk	
ese	mcq	
arandai	jbj	
tikar	tik	
laki	lki	
bakpinka	bbs	
kari	kbj	
kiorr	xko	
judeo-spanish	lad	
vaghat-ya-bijim-legeri	bij	
campidanese sardinian	sro	
yokuts	yok	
western tunebo	tnb	
mayi-thakurti	xyt	
me'en	mym	
yabong	ybo	
cakchiquel-quiché mixed language	ckz	
barai	bbb	
napu	npy	
magbukun ayta	ayt	
byangsi	bee	
rifao	nmw	
yabula yabula	yxy	
rumai palaung	rbb	
kwesten	kwt	
walangama	nlw	
ubir	ubr	
kiowa	kio
kichaga	jmc
ambakich	aew	
sinsauru	snz	
siroi	ssd	
fulniô	fun	
romano-greek	rge	
mbara (chad)	mpk	
lembena	leq	
ormuri	oru	
parakanã	pak	
dori'o	dor	
humburi senni songhay	hmb	
ndaka	ndk	
defaka	afn	
pulaar	fuc	
ngoreme	ngq	
imbabura quechua	qvi	
cruzeño	crz	
malê	hot	
indonesian sign language	inl	
kupa	kug	
putai	mfl	
marino	mrb	
tugun	tzn	
masikoro malagasy	msh	
uzbeki arabic	auz	
lavatbura-lamusong	lbv	
maxi gbe	mxl	
picene	nrp	spx	
waata	ssn	
saliba	sbe	
kao	kax	
kambiwá	xbw	
indo-portuguese	idb	
mo	wkd	
cahuarano	cah	
hadrami	xhd	
bilakura	bql	
eastern ojibwa	ojg	
taiwanese	nan	
western lawa	lcp	
luvale	lue	
kekchí	kek	
gujarati	guj	
eastern krahn	kqo	
luang	lex	
mouwase	jmw	
maiadomu	mzz	
western durango nahuatl	azn	
nuni	nnw	nuv	
chuwabu	chw	
eastern qiandong miao	hmq	
tarahumara	tac	tar	tcu	thh	twr	
kula	tpg	
lezghian	lez	
lenyima	ldg	
gawwada	gwd	
colorado	cof	
kapriman	dju	
huallaga huánuco quechua	qub	
skou	skv	
andoa	anb	
lingarak	lgk	
moose cree	crm	
north tairora	tbg	
enu	enu	
wali (ghana)	wlx	
bunoge dogon	dgb	
mpi	mpz	
loniu	los	
kembayan	xem	
portuguese	por	
tatana	txx	
karachay-balkar	krc	
arára	aap	axg	
kwaya	kya	
adi	adi	
loup a	xlo	
tidikelt tamazight	tia	
djingili	jig	
neo-hittite	nei	
cantonese	yue	
rer bare	rer	
axamb	ahb	
kati	bsh	
northeast pashai	aee	
sebuyau	snb	
nhanda	nha	
beami	beo	
nefamese	nef	
chaozhou	nan	
sholaga	sle	
dogri (individual language)	dgo	
xiri	xii	
southern samo	sbd	
odoodee	kkc	
tetete	teb	
koresh-e rostam	okh	
atemble	ate	
tektiteko	ttc	
bonan	peh	
matal	mfh	
hatam	had	
bulgarian	bul	chu	
baramu	bmz	
nahuatl	azd	azn	azz	naz	nch	nci	ncj	ncl	ncx	ngu	nhc	nhe	nhg	nhi	nhk	nhm	nhn	nhp	nhq	nht	nhv	nhw	nhx	nhy	nhz	nlv	npl	nsu	nuz	
bumaji	byp	
zaghawa	zag	
basa-gurmana	buj	
dair	drb	
sissala	sld
morelos nahuatl	nhm	
nyika (malawi and zambia)	nkv	
malvi	mup	
sateré-mawé	mav	
manangba	nmm	
roma	rmm	
bhadrawahi	bhd	
omagua	omg	
oring	org	
ikwo	iqw	
maritsauá	msp	
mittimatalik	ike	
zimbabwe sign language	zib	
yonaguni	yoi	
kendayan	knx	
mochi	old	
katla	kcr	
wambule	wme	
miji	sjl	
duungooma	dux	
jumla sign language	jus	
tumbuka	tum	
quechan	yum	
kenaboi	xbn	
gana	gnq	
somyev	kgt	
iau	tmu	
mamulique	emm	
warumungu	wrm	
iatmul	ian	
ngbinda	nbd	
tawallammat tamajaq	ttq	
kaiep	kbw	
kusaghe	ksg	
ngamambo	nbv	
zhang-zhung	xzh	
songhai	ses	
luo (kenya and tanzania)	luo	
konkomba	xon	
apalachee	xap	
futuna-aniwa	fut	
loreto-ucayali spanish	spq	
emberá-tadó	tdc	
bari	bfa	
yugul	ygu	
riverain sango	snj	
mattole	mvb	
barwe	bwg	
kapauri	khp	
giziga	gis	giz	
bintauna	bne	
gudu	gdu	
mango	mge	
mbara (australia)	mvl	
tsucuba	cbq	
dema	dmx	
medieval greek	qgk	
chinook	chh	
bareli	bfb	bgd	bpx	
cemuhî	cam	
besoa	bep	
kenzi	xnz	
trieng	stg	
nyoro	nyo	
gwahatike	dah	
nchumbulu	nlu	
toro so dogon	dts	
northeast kiwai	kiw	
southwestern dinka	dik	
siyin chin	csy	
pémono	pev	
southern altai	alt	
moraid	msg	
naki	mff	
okolod	kqv	
beaver	bea
kháng	kjm	
nogai	nog	
konso	kxc	
hakka chinese	hak	
ginuman	gnm	
lanas lobu	ruu	
vlax romani	rmy	
western pantar	lev	
simbari	smb	
layakha	lya	
ziriya	zir	
nyangatom	nnj	
raetic	xrr	
sanga (democratic republic of congo)	sng	
northern guiyang miao	huj	
luwo	lwo	
woleaian	woe	
nottoway	ntw	
maithili	mai	
asuri	asr	
punan aput	pud	
lango (uganda)	laj	
dondo	dok	
kohumono	bcs	
tabaru	tby	
nkonya	nko	
chuukese	chk	
yaqay	jaq	
tumshuqese	xtq	
ukit	umi	
bekwarra	bkv	
makhuwa-moniga	mhm	
kua	tyu	
southern bobo madaré	bwq	
sherdukpen	sdp	
low saxon	nds	
zayse-zergulla	zay	
central kanuri	knc	
nkukoli	nbo	
idaté	idt	
kukele	kez	
ume sami	sju	
záparo	zro	
ticuna	tca	
mwera (nyasa)	mjh	
waorani	auc	
amatlán zapotec	zpo	
mende (papua new guinea)	sim	
simbali	smg	
naxi	nxq	
kankanay	xnn	
tabaa zapotec	zat	
mayan	emy	
nkongho	nkc	
north russian	rus	
mulam	mlm	
kiswahili	swh	
minoan	omn	
sissano	sso	
bipi	biq	
réunion creole french	rcf	
sengseng	ssz	
olushisa	lks	
chol	ctu	
laomian	lwm	
waioli	wli	
ngie	ngj	
adhola	adh	
surayt	tru	
murrinypata	mwf	
angosturas tunebo	tnd	
ometepec nahuatl	nht	
katu	ktv	kuf	
kemtuik	kmt	
moronene	mqn	
lower sorbian	dsb	
saponi	spi	
susquehannock	sqn	
naka'ela	nae	
diri	dwa	
nadruvian	ndf	
termanu	twu	
adamorobe sign language	ads	
desiya	dso	
thulung	tdh	
reyesano	rey	
san salvador kongo	kwy	
yevanic	yej	
majang	mpe	
jur modo	bex	
kura ede nago	nqk	
archi	aqc	
kaska	kkz	
monumbo	mxk	
yakama	yak	
bunganditj	xbg	
mághdì	gmd	
miraya bikol	rbl	
laka (chad)	lap	
wandamen	wad	
niwer mil	hrc	
tokharian a	xto	
grass koiari	kbk	
pa'o	blk	
abon	abo	
aghwan	xag	
ndunga	ndt	
samtao	stu	
oro	orx	
manikion	mnx	
anjam	boj	
maremgi	mrx	
taliabu	tlv	
kipfokomo	pkb	
tulehu	tlu	
latu	ltu	
adonara	adr	
muniche	myr	
tangale	tan	
eastern parbate kham	kif	
itza	itz	
austral	aut	
kla-dan	lda	
phola	ypg	ypo	
thaiphum chin	cth	
araki	akr	
maragus	mrs	
bamukumbit	bqt	
hua	ygr	
yawarawarga	yww	
koasati	cku	
sene	sej	
tagish	tgx	
zaiwa	atb	
wik-ngathana	wig	
alutor	alr	
mok	mqt	
wakabunga	wwb	
big nambas	nmb	
roon	rnn	
bwe karen	bwe	
didinga	did	
isebe	igo	
northern talyshi	tly	
mewari	mtr	
yemsa	jnj	
kamu	xmu	
isnag	isd	
kwang	kvi	
biem	bmc	
langnian buyang	yln	
bangingih sama	sse	
buyang	yha	yln	yzg	
aklanon	akl	
eastern frisian	frs	
amo	amo	
dulbu	dbo	
welsh romani	rmw	
vidunda	vid	
wahgi	wgi	whg	
vietnamese	vie	
south azerbaijani	azb	
kandawo	gam	
bilaspuri	kfs	
sam	snx	
erromintxela	emx	
aranadan	aaf	
ndebele	nbl	nde	
punu	puu	
kotafon gbe	kqk	
gujari	gju	
uvbie	evh	
kanamarí	knm	
wanman	wbt	
tibetan	adx	bod	khg	otb	xct	
karamojong	kdj	
tegali	ras	
vincentian creole english	svc	
kitsai	kii	
walla walla	waa	
riang (india)	ria	
gedaged	gdd	
mong	hmn	
sahu	saj	
chalcatongo mixtec	mig	
tha	thy	
nume	tgs	
old hungarian	ohu	
rungtu chin	rtc	
kaxuiâna	kbb	
dan	dnj	
mwatebu	mwa	
dizin	mdx	
kumam	kdi	
mandara	tbf	
ngongo	noq	
middle breton	xbm	
ndoola	ndr	
badyara	pbp	
mazagway	dkx	
suomenruotsalainen viittomakieli	fss	
zabana	kji	
alur	alz	
piamatsina	ptr	
merlav	mrm	
bure	bvh	
waritai	wbe	
lega-mwenga	lgm	
purari	iar	
mefele	mfj	
boghom	bux	
obanliku	bzy	
taworta	tbp	
buhi'non bikol	ubl	
waci gbe	wci	
western penan	pne	
macanese	mzs	
homa	hom	
najdi arabic	ars	
guriaso	grx	
garifuna	cab	
saba	saa	
oriya	ort	ori	
pei	ppq	
ganza	gza	
tagal murut	mvv	
pattani	lae	
kurux	kxl	
katukína	kav	knt	
pidgin	pcm	tvy	wes	
tübatulabal	tub	
parya	paq	
githabul	gih	
konda-dora	kfc	
kpeego	cpo	
yaminahua	yaa	
bitur	mcc	
warlmanpa	wrl	
bable	ast	
nyemba	nba	
bishuo	bwh	
bahinemo	bjh	
camling	rab	
lalu	yit	ywl	
tewa (indonesia)	twe	
nago	nqg	xkb	
eastern mari	mhr	
kim	kia	
jaitmatang	xjt	
eastern arrernte	aer	
northeastern pomo	pef	
guezenaya taryfit berber	rif	
sindhi	snd	
phupa	ypp	
umeda	upi	
gibanawa	gib	
moikodi	mkp	
amol	alx	
east yugur	yuy	
mabaale	mmz	
mainstream kenyah	xkl	
marwari	mwr	
nakanai	nak	
ambrak	aag	
logo	log	
saafi-saafi	sav	
large flowery miao	hmd	
northern kalapuya	nrt	
lehar	cae	
pijin	pis	
paraguayan sign language	pys	
southern alta	agy	
daasanach	dsh	
matepi	mqe	
tupí	tpw	
macedo-romanian	rup	
northern pashto	pbu	
upper sorbian	hsb	
sabine	sbv	
lower southern aranda	axl	
nyankole	nyn	
sandawe	sad	
mullu kurumba	kpb	
tabassaran	tab	
ega	ega	
sos kundi	sdk	
old lithuanian	olt	
hajong	haj	
ozolotepec zapotec	zao	
north fali	fll	
hmar	hmr	
malgbe	mxf	
hukumina	huw	
haitian vodoun culture language	hvc	
bädi kanum	khd	
makolkol	zmh	
crimean turkish	crh	
northern amami-oshima	ryn	
laitu chin	clj	
mwali comorian	wlc	
kunduvadi	wku	
savi	sdg	
batak mandailing	btm	
mattoki	xnz	
bamenyam	bce	
umon	umm	
tsikimba	kdl	
wunai bunu	bwn	
ngombe (democratic republic of congo)	ngc	
ubang	uba	
hmwaveke	mrk	
madi	grg	
kutong	skm	
yucuna	ycn	
kiwilwana	mlk	
holma	hod	
walser	wae	
barombi	bbi	
guarani	grn	
buhid	bku	
haitian creole	hat	
sukurum	zsu	
central okinawan	ryu	
so (democratic republic of congo)	soc	
huachipaeri	hug	
tjurruru	tju	
bhunjia	bhu	
batuley	bay	
jewish palestinian aramaic	jpa	
yogad	yog	
awbono	awh	
andra-hus	anx	
kwadi	kwz	
kho'ini	xkc	
south african sign language	sfs	
guana (brazil)	gqn	
gungu	rub	
nüpode huitoto	hux	
ntcham	bud	
dongolawi	dgl	
chamari	cdg	
gwamhi-wuri	bga	
elymian	xly	
southwestern tlaxiaco mixtec	meh	
sangtam naga	nsa	
taikat	aos	
buli (ghana)	bwu	
enxet	enx	
urdu	urd	
larike	alo	
obispeño	obi	
djabwurrung	tjw	
psikye	kvj	
alaba-k’abeena	alw	
pamplona atta	att	
isinai	inn	
moldova sign language	vsi	
tocho	taz	
manda (india)	mha	
beele	bxq	
babar	bcd	vbb	
manipa	mqp	
taungyo	tco	
lule	ule	
marti ke	zmg	
tembo (kitembo)	tbt	
esselen	esq	
lenakel	tnl	
serili	sve	
jeng	jeg	
bai	bca	bdj	bfc	bfs	lay	
epena	sja	
makuri naga	jmn	
popti'	jac	
ndambomo	nxo	
anal	anm	
zaachila zapotec	ztx	
russian (rus) + english	eng	
jina	jia	
baygo	byg	
koro wachi	bqv	
comanche	com	
banda-bambari	liy	
palikúr	plu	
asunción mixtepec zapotec	zoo	
kaike	kzq	
yindjilandji	yil	
bungain	but	
afro-seminole creole	afs	
gabrielino-fernandeño	xgf	
liberian english	lir	
tai	taw	
xipaya	xiy	
phong-kniang	pnx	
waurá	wau	
tela-masbuar	tvm	
lisu	lis	
murkim	rmh	
gadsup	gaj	
mamanwa	mmn	
enets	enf	enh	
lamkang	lmk	
baiso	bsw	
rikbaktsa	rkb	
manange	nmm	
panyjima	pnw	
nagumi	ngv	
kansa	ksk	
hindustani	hns	
mangarayi	mpc	
dhivehi	div	
ombo	oml	
rumu	klq	
moo	gwg	
marik	dad	
lamu-lamu	lby	
ngeq	ngt	
tedaga	tuq	
tepetotutla chinantec	cnt	
a'ou	aou	
buxinhua	bgk	
koraga	kfd	vmd	
dalmatian	dlm	
nisi (china)	yso	
rien	rie	
bina (nigeria)	byj	
northern conchucos ancash quechua	qxn	
namosi-naitasiri-serua	bwb	
tsakwambo	kvz	
sadri	sck	sdr	
samay	syx	
tavringer romani	rmu	
madagascar sign language	mzc	
miyako	mvi	
negidal	neg	
tornedalen finnish	fit	
umpila	ump	
baga koga	bgo	
iha based pidgin	ihb	
mamasa	mqj	
ruund	rnd	
bawm chin	bgr	
lachiguiri zapotec	zpa	
south slavey	xsl	
nêlêmwa-nixumwak	nee	
mende (sierra leone)	men	
gwak	jgk	
jèrriais	nrf	
nyarafolo senoufo	sev	
nalik	nal	
northern toussian	tsp	
carian	xcr	
nahuatl (nhw:nhe) + spanish	spa	
kaiwá	kgk	
manombai	woo	
central puebla nahuatl	ncx	
'ôrôê	bpk	
baka (sudan)	bdh	
yay	yoy	
tayo	cks	
paipai	ppi	
mehri	gdq	
yabaâna	ybn	
mopán maya	mop	
punan merap	puc	
lorang	lrn	
sara	sre	
nyanga-li	nyc	
fordata	frd	
phana'	phq	
bwamu	bwj	bwy	
ngarluma	nrl	
grebo	gbo	gec	grb	grj	grv	gry	
alugu	aub	
urubú-kaapor sign language	uks	
ngadjunmaya	nju	
duruma	dug	
jingulu	jig	
longuda	lnu	
makhuwa-marrevone	xmc	
banaro	byz	
interlingue	ile	
buruwai	asi	
tshangla	tsj	
miami	mia	
san blas kuna	cuk	
taiap	gpn	
pnar	pbv	
banda (indonesia)	bnd	
mengisa	mct	
lunda	lun	
dakota	dak	
cofán	con	
old uighur	oui	
wik-epa	wie	
hutterisch	geh	
dera (nigeria)	kna	
geba karen	kvq	
finlandssvenskt teckenspråk	fss	
chinesischen	cmn	
maii	mmm	
nganakarti	xnk	
bakhtiari	bqi	
fulah	ful	
cacaopera	ccr	
musasa	smm	
northern tlaxiaco mixtec	xtn	
batui	zbt	
haitian	hat	
central huasteca nahuatl	nch	
lele (chad)	lln	
makasar	mak	
luyia	luy	
gundi	gdi	
gorontalo	gor	
achinese	ace	
magɨyi	gmg	
berta	wti	
anamgura	imi	
wailapa	wlr	
oloma	olm	
central tagbanwa	tgt	
matukar	mjk	
awetí	awe	
siriano	sri	
krongo	kgo	
mali	gcc	
neapolitan	nap	
mboi	moi	
northern yukaghir	ykg	
balau	blg	
seki	syi	
western totonac	tqt	
pokangá	pok	
salampasu	slx	
oya'oya	oyy	
mising	mrg	
sa	sax	
muduga	udg	
ngawn chin	cnw	
sakan	kho	
nkoya	nka	
xakriabá	xkr	
heung kong sau yue	hks	
fagani	faf	
panará	kre	
aka-kol	aky	
siksika	bla	
baraamu	brd	
jola-fonyi	dyo	
pisabo	pig	
nimanbur	nmp	
minigir	bxf	
jiba	juo	
atong (cameroon)	ato	
rabha	rah	
pipil	ppl	
merei	lmb	
venda	ven	
min bei chinese	mnp	
sikiana	sik	
karipuna	kuq	
nindi	nxi	
northwest pashai	glh	
edera awyu	awy	
neverver	lgk	
chamacoco	ceg	
mbula-bwazza	mbu	
gurung	gvr	
sihuas ancash quechua	qws	
palpa	plp	
huave	hue	huv	hve	hvv	
youle jinuo	jiu	
máku	xak	
sicanian	sxc	
letzeburgesch	ltz	
kuku-ugbanh	ugb	
pauri bareli	bfb	
antakarinya	ant	
tangoa	tgp	
mandinka	mnk	
sylheti	syl	
avava	tmb	
mlap	kja	
chechen	che	
lala	nrz	
badimaya	bia	
bimin	bhl	
latundê	ltn	
kayong	kxy	
digo	dig	
bakumpai	bkr	
younuo bunu	buh	
tukpa	tpq	
dyaabugay	dyy	
daho-doo	das	
ndonga	ndo	
southwestern nisu	nsv	
ouma	oum	
toraja-sa'dan	sda	
laven	lbo	
southwest tanna	nwi	
yora	mts	
tauade	ttd	
maria (papua new guinea)	mds	
tuvalu	tvl	
munggui	mth	
dagoman	dgn	
multiple languages	mul	
tuxá	tud	
busang kayan	bfg	
mosiro	mwy	
salako	knx	
eastern acipa	acp	
esuma	esm	
thao	ssf	
voro	vor	
brithenig	bzt	
eastern durango nahuatl	azd	
eastern balochi	bgp	
tobo	tbv	
sekak	lce	
gureng gureng	gnr	
caddo	cad	
bolo	blv	
atsugewi	atw	
varhadi-nagpuri	vah	
chidigo	dig	
asu (nigeria)	aum	
mi'kmaq	mic	
zazao	jaj	
laurentian	lre	
creole malay	ccm	sci	
tsimihety malagasy	xmw	
kasanga	ccj	
hitu	htu	
tumleo	tmq	
lucumi	luq	
nama (namibia)	naq	
tamajeq	thz	
mangayat	myj	
ronji	roe	
nyambo	now	
tanimbili	tbe	
okanagan	oka	
mpuono	zmp	
pai tavytera	pta	
gavião do jiparaná	gvo	
buduma	bdm	
sajalong	sjl	
tapirapé	taf	
wajuk	xwj	
karipúna	kgm	
luidakho-luisukha-lutirichi	ida	
markweeta	enb	
inlaod itneg	iti	
yakoma	yky	
bera	brf	
kulung (nigeria)	bbu	
gants	gao	
ambala ayta	abc	
manem	jet	
kota bangun kutai malay	mqg	
ulau-suain	svb	
tetelcingo nahuatl	nhg	
ndamba	ndj	
ben tey dogon	dbt	
iranun (malaysia)	ilm	
mossi	mos	
unde kaili	unz	
mum	kqa	
margany	zmc	
koluwawa	klx	
hani	hni	
waffa	waj	
munda	unx	
trinitario	trn	
mualang	mtd	
mangbetu	mdj	
banggai	bgz	
pyu (myanmar)	pyx	
ravula	yea	
kedah malay	meo	
tobilung	tgb	
nukuria	nur	
bininj gun-wok	gup	
braj	bra	
chimborazo highland quichua	qug	
kabardian	kbd	
ancient macedonian	xmk	
english	ang	eng	enm	lir	
batak dairi	btd	
malayo	mbp	
arvanitika albanian	aat	
adzera	adz	
chukwa	cuw	
likwala	kwc	
upper tanana	tau	
tena lowland quichua	quw	
okobo	okb	
inpui naga	nkf	
betawi	bew	
wiru	wiu	
hmong shua	hmz	
maninka	mku	msc	
central tunebo	tuf	
wolaytta	wal	
yango	yng	
tabasco nahuatl	nhc	
newari	new	nwc	
koro (papua new guinea)	kxr	
pye krumen	pye	
laos sign language	lso	
yuru	ljx	
santa maría del mar huave	hvv	
chinantec	cco	chj	chq	chz	cle	cnl	cnt	cpa	csa	cso	cte	ctl	cuc	cvn	
flinders island	fln	
yurutí	yui	
gbari	gby	
gade lohar	gda	
!xóõ	nmn	
kayagar	kyt	
gola	gol	
timucua	tjm	
wushi	bse	
kangri	xnr	
lingala	lin	
keiga	kec	
lawa	lcp	lwl	
banda-yangere	yaj	
kamberau	irx	
dayi	dax	
tapei	afp	
ajawa	ajw	
liv	liv	
gweno	gwe	
so'a	ssq	
peripheral mongolian	mvf	
kanggape	igm	
tajio	tdj	
rapoisi	kyx	
sa'a	apb	
dass	dot	
cimbrian	cim	
lubu	lcf	
nnam	nbp	
marind	bpv	mrz	
tunia	tug	
seko tengah	sko	
orang seletar	ors	
tasmate	tmt	
tofanma	tlg	
carijona	cbd	
danish (dan) + norwegian	nob	
rema	bow	
rawang	raw	
coquille	coq	
caka	ckx	
kove	kvc	
barzani jewish neo-aramaic	bjf	
bwela	bwl	
tobagonian creole english	tgh	
southern rengma naga	nre	
finland-swedish sign language	fss	
wadi wadi	xwd	
avokaya	avu	
kaian	kct	
latvian romani	rml	
estonian sign language	eso	
kamta	rkt	
tobelo	tlb	
lega-shabunda	lea
lega	lea
mulao	giu	
boko (benin)	bqc	
bugan	bbh	
buli (indonesia)	bzq	
waimaha	bao	
central k'iche'	quc	
bierebo	bnk	
usui	usi	
bolia	bli	
tepehua	tee	tpp	tpt	
mawayana	mzx	
macushi	mbc	
nateni	ntm	
daatsʼíin	dtn	
sawila	swt	
bhilali	bhi	
ta'oih	tth	tto	
nali	nss	
mandaic	mid	myz	
icelandic	isl	
papiamento	pap	
ersu	ers	
southern qiang	qxs	
yuqui	yuq	
central-eastern niger fulfulde	fuq	
maring	mbw	
turumsa	tqm	
linear a	lab	
tagalaka	tgz	
kupsabiny	kpz	
eggon	ego	
cherepon	cpn	
toba	tob	
yabem	jae	
jingpho	kac	
erzya	myv	
larevat	lrv	
malaccan creole portuguese	mcm	
malawi lomwe	lon	
trimuris	tip	
paku karen	jkp	
lopa	lop	
wasa	wss	
biseni	ije	
kaulong	pss	
yom	pil	
nyanja	nya	
lemolang	ley	
nanerigé sénoufo	sen	
indonesian bajau	bdl	
popoluca	plo	poi	poq	pos	
dumun	dui	
kisongo maasai	mas	
besisi	mhe	
tidaá mixtec	mtx	
nyokon	nvo	
zizilivakan	ziz	
potiguára	pog	
makaa	mcp	
gobasi	goi	
wedau	wed	
tanudan kalinga	kml	
reli	rei	
valencian sign language	vsv	
west-central limba	lia	
toura (papua new guinea)	don	
old basque	mis	
muslim tat	ttt	
indri	idr	
oluluyia	luy	
namuyi	nmy	
selangor sign language	kgi	
khehek	tlx	
sorsoganon	bks	srv	
bragat	aof	
keninjal	knl	
narrinyeri	nay	
galolen	gal	
dido	ddo	
taloki	tlk	
neve'ei	vnm	
isarog agta	agk	
kikai	kzg	
laha (viet nam)	lha	
limbum	lmp	
kaure	bpp	
bashkardi	bsg	
chug	cvg	
paelignian	pgn	
wuvulu-aua	wuv	
tamagario	tcg	
kamakan	vkm	
alsatian	gsw	
bantik	bnq	
khirwar	kwx	
mapuche	arn	
svan	sva	
northern uzbek	uzn	
hanoi sign language	hab	
natchez	ncz	
waris	wrs	
darang deng	mhu	
magdalena peñasco mixtec	xtm	
muruwari	zmu	
giryama	nyf	
budeh stieng	stt	
djauan	djn	
kinamiging manobo	mkx	
yakha	ybh	
bamun	bax	
marúbo	mzr	
loxicha zapotec	ztp	
tukumanféd	tkf	
okiek	oki	
albanian sign language	sqk	
kalinga	kkg	kmd	kmk	kml	knb	ksc	kyb	
zigula	ziw	
indian sign language	ins	
thai sign language	tsq	
ottoman turkish (1500-1928)	ota	
baldemu	bdn	
feroge	fer	
teribe	tfr	
njen	njj	
kanuri	bms	kau	kby	knc	krt	
kuwaataay	cwt	
tanggu	tgu	
rundi	run	
ukaan	kcf	
kuman (russia)	qwm	
ainbai	aic	
warduji	wrd	
prasuni	prn	
safaliba	saf	
darkinyung	xda	
judeo-persian	jpr	
gurdjar	gdj	
cwi bwamu	bwy	
parawen	prw	
pilipino	fil	
paluan	plz	
mara	mec	
madngele	zml	
maori	mri	rar	
lamang	hia	
sui	swi	
zhoa	zhw	
gavião	gvp	
taroko	trv	
abé	aba	
puma	pum	
kenati	gat	
lote	uvl	
eastern mnong	mng	
quenya	qya	
aruá (amazonas state)	aru	
'are'are	alu	
yandruwandha	ynd	
uma	ppk	
jonkor bourmataguil	jeu	
alemannic	gsw	
woi	wbw	
yaroamë	yro	
eritai	ert	
cham	cja	cjm	
rajput garasia	gra	
avikam	avi	
niuatoputapu	nkp	
huitepec mixtec	mxs	
vute	vut	
buraka	bkg	
tilquiapan zapotec	zts	
gozarkhani	goz	
mambila	mcu	mzk	
bayungu	bxj	
kaiy	tcq	
mískito	miq	
tonga (zambia)	toi	
kuturmi	khj	
cerma	cme	
imperial aramaic (700-300 bce)	arc	
tolomako	tlm	
nyawaygi	nyt	
jahanka	jad	
wardaman	wrr	
arritinngithigh	rrt	
kiowa apache	apk	
paranawát	paf	
mikasuki	mik	
boano (sulawesi)	bzl	
south central banda	lnl	
sirenik yupik	ysr	
ngoshie	nsh	
laghu	lgb	
tawang monpa	twm	
tho	tou	
butbut kalinga	kyb	
lala-roba	lla	
central mashan miao	hmm	
kendeje	klf	
muyuw	myw	
hahon	hah	
cypriot arabic	acy	
ofayé	opy	
hulaulá	huy	
katbol	tmb	
purum	pub	
natügu	ntu	
san miguel creole french	scf	
pwo northern karen	pww	
kalenjin	kln	
ngurmbur	nrx	
molo	zmo	
powari	pwr	
riung	riu	
seru	szd	
karawa	xrw	
minderico	drc	
cornish	cnx	cor	oco	
jamaican creole english	jam	
sawi	saw	
anuki	aui	
palenquero	pln	
icelandic sign language	icl	
louisiana creole	lou	
iquito	iqu	
ngundi	ndn	
tambas	tdk	
ngaing	nnf	
laha (indonesia)	lhh	
pushto	pus	
san marcos tlacoyalco popoloca	pls	
auyokawa	auo	
duruwa	pci	
dzalakha	dzl	
ayizi	yyz	
dalabon	ngk	
east tarangan	tre	
chortí	caa	
makhuwa-shirima	vmk	
mbangi	mgn	
adang	adn	
batyala	xby	
vandalic	xvn	
abun	kgr	
lari	lrl	
wusa nasu	yig	
western bolivian guaraní	gnw	
ishkashimi	isk	
iko	iki	
menya	mcr	
phupha	yph	
méa	cir	
nengone	nen	
danish sign language	dsl	
urapmin	urm	
mengen	mee	
kunda	kdn	
tezoatlán mixtec	mxb	
sok	skk	
nuk	noc	
northwestern tamang	tmk	
aghem	agq	
yao	yao	
razajerdi	rat	
kuuku-ya'u	kuy	
burusu	bqr	
kuman (papua new guinea)	kue	
mosetén	cas	
old provençal (to 1500)	pro	
siamou	sif	
bekati'	bei	
caribbean javanese	jvn	
tepehuan	ntp	stp	tla	
old tamil	oty	
isthmus-mecayapan nahuatl	nhx	
san lucas quiaviní zapotec	zab	
saam	raq	
falam chin	cfm	
setaman	stm	
lardil	lbz	
horpa	ero	
hupdë	jup	
trinidad and tobago sign language	lst	
chakma	ccp	
komo (democratic republic of congo)	kmw	
crimean tatar	crh	
algonquin	alq	
ge	hmj	
jiamao	jio	
bu	jid	
aweer	bob	
vurës	msn	
marghi south	mfm	
ningye	nns	
lemnian	xle	
yucuañe mixtec	mvg	
eastern ngad'a	nea	
maybrat	ayz	
binukid	bkd	
eastern maninkakan	emk	
malaryan	mjq	
ngambay	sba	
southern kiwai	kjd	
baniva	bvv	
kaqchikel	cak	
awtuw	kmn	
min zhong chinese	czo	
yagua	yad	
odut	oda	
akaselem	aks	
salish	slh	str	
loo	ldo	
golin	gvf	
badjiri	jbi	
puimei naga	npu	
malay (individual language)	zlm	
fyer	fie	
arosi	aia	
maninkakan	emk	mlq	mwk	
aer	aeq	
yamap	ymp	
orang kanaq	orn	
juray	juy	
mlomp	mlo	
maya samo	sym	
san miguel el grande mixtec	mig	
jejueo	jje	
kare (papua new guinea)	kmf	
parachi	prc	
hawai'i creole english	hwc	
old chinese	och	
leelau	ldk	
nalögo	nlz	
lesing-gelimi	let	
mutu	tuc	
acroá	acs	
azoyú tlapanec	tpc	
kafa	kbr	
imbongu	imo	
white gelao	giw	
kodava	kfa	
south efate	erk	
lovono	vnk	
aguacateco	agu	
poumei naga	pmx	
polonombauk	plb	
jadgali	jdg	
western fijian	wyy	
chambeali	cdh	
shendu	shl	
loloda	loa	
aleut	ale	mud	
njyem	njy	
laro	lro	
hawaiian	haw	
middle armenian	axm	
malayalam	mal	
gapapaiwa	pwg	
zarphatic	zrp	
kemberano	bzp	
dubu	dmu	
nungu	rin	
bonkiman	bop	
waiwai	waw	
hupla	hap	
senggi	snu	
banao itneg	bjx	
pali	pli	
biali	beh	
minriq	mnq	
tetun	tdt	
kanoé	kxo	
nenets	yrk	
buamu	box	
koryak	kpy	
kulina pano	xpk	
northern east cree	crl	
kominimung	xoi	
tai long	thi	
angoram	aog	
waruna	wrv	
ibaloi	ibl	
sulod	srg	
tippera	tpe	
snohomish	sno	
allar	all	
bainouk-gunyaamolo	bcz	
mari (east sepik province)	mbx	
bidhawal	ihw	
kudmali	kyw	
sakha	sah	
tepo krumen	ted	
kuanhua	xnh	
ruga	ruh	
taruma	tdm	
mili	ymh	
gagnoa bété	btg	
telugu	tel	
acehnese	ace	
anu-hkongso chin	anl	
thuri	thu	
mbukushu	mhw	
ngatik men's creole	ngm	
yamongeri	ymg	
remo	rem	
finnish	fin	fit	fkv	
tukang besi	bhq	
anambé	aan	
south bolivian quechua	quh	
san juan atzingo popoloca	poe	
tanacross	tcb	
kirya-konzəl	fkk	
east futuna	fud	
khe	kqg	
mandobo atas	aax	
kaxararí	ktx	
njebi	nzb	
talaud	tld	
palor	fap	
pacahuara	pcp	
mokpwe	bri	
sorkhei	sqo	
serrano	ser	
baikeno	bkx	
yekora	ykr	
libon bikol	lbl	
gizrra	tof	
tlahuitoltepec mixe	mxp	
naskapi	nsk	
enga	enq	
kituba (democratic republic of congo)	ktu	
tenis	tns	
lemerig	lrz	
higaonon	mba	
repanbitip	rpn	
matipuhy	mzo	
southern carrier	caf	
korlai creole portuguese	vkp	
sere	swf	
gao	gga	
oksapmin	opm	
lorediakarkar	lnn	
algonquian	crr	
motu	meu	
quinqui	quq	
vinmavis	vnm	
kota (india)	kfe	
kachama-ganjule	kcx	
chayahuita	cbt	
ramoaaina	rai	
ifo	iff	
sumau	six	
laragia	lrg	
bile	bil	
crioulo	pov	
aruamu	msy	
kanasi	soq	
old church slavonic	chu	
iyojwa'ja chorote	crt	
karon	krx	
duri	mvp	
agoi	ibm	
weyto	woy	
obolo	ann	
nyiyaparli	xny	
mouk-aria	mwh	
yiddish	ydd	yid	yih	
timor pidgin	tvy	
turkish sign language	tsm	
valman	van	
menka	mea	
central palawano	plc	
tanna	nwi	tnn	
abipon	axb	
nilamba	nim	
spanish sign language	ssp	
kaco'	xkk	
chewa	nya	
asturleonese	ast	
gudanji	nji	
central masela	mxz	
korwa	kfp	
highland totonac	tos	
ngbaka manza	ngg	
pittapitta	pit	
angaataha	agm	
mungbam	mij	
eton (cameroon)	eto	
central maewo	mwo	
kibet	kie	
pangseng	pgs	
gal	gap
yue chinese	yue	
lokaa	yaz	
mwani	wmw	
lese	les	
kare (central african republic)	kbn	
judeo-moroccan arabic	aju	
alumu-tesu	aab	
mekmek	mvk	
ainu (china)	aib	
chorti	caa	
vure	lkn	
merwari	wry	
o'chi'chi'	xoc	
chiltepec chinantec	csa	
shipibo-conibo	shp	
aari	aiw	
nuuchahnulth	nuk	noo	
kwer	kwr	
cabécar	cjp	
olukhayo	lko	
yupik	ems	ess	esu	ynk	ysr	ypk
ikoma-nata-isenye	ntk	
fulfulde	ffm	fub	fue	fuh	fui	fuq	fuv	
sakata	skt	
southern pumi	pmj	
marfa	mvu	
kugama	kow	
suyá	suy	
yan-nhangu	jay	
mbay	myb	
cañar highland quichua	qxr	
ngom	nra	
glavda	glw	
kono (guinea)	knu	
kuvale	olu	
pekal	pel	
pakistan sign language	pks	
harami	xha	
terik	tec	
santa inés ahuatempan popoloca	pca	
ajumbu	muc	
karipúna creole french	kmv	
chibcha	chb	
tena	bfe	
southeast babar	vbb	
wadiyara koli	kxp	
kantosi	xkt	
northern kurdish	kmr	
cua	cua	
ukpet-ehom	akd	
enawené-nawé	unk	
northern roglai	rog	
san vicente coatlán zapotec	zpt	
lusengo	lse	
tula	tul	
tuotomb	ttf	
numanggang	nop	
neyo	ney	
munit	mtc	
sharanahua	mcd	
papora	ppu	
konni	kma	
pahi	lgt	
mashi (zambia)	mho	
french (fra) + moroccan arabic	ary	
hungana	hum	
lombi	lmi	
kol	ekl	
island carib	crb	
western mashan miao	hmw	
paunaka	pnk	
eipomek	eip	
southern ohlone	css	
western krahn	krw	
asurini	asu	
barapasi	brp	
iñapari	inp	
bidyara	bym	
carabayo	cby	
solos	sol	
tsotso	lto	
yakaikeke	ykk	
talondo'	tln	
dorze	doz	
ibino	ibn	
chimakum	xch	
abkhaz	abk	
phalura	phl	
old english	ang	
veluws	vel	
eastern tamang	taj	
tchumbuli	bqa	
hinduri	hii	
gambian wolof	wof	
nong zhuang	zhn	
koda	cdz	
zangskari	zau	
bangala	bxg	
pardhi	pcl	
mundurukú	myu	
novial	nov	
punan bah-biau	pna	
bilin	byn	
lodhi	lbm	
mingrelian	xmf	
mekeo	mek	
sokoro	sok	
akawaio	ake	
tuki	bag	
nande	nnb	
vishavan	vis	
westphalien	wep	
occitan	pro	
daba	dbq	
kamantan	kci	
tswana	tsn	
nigeria mambila	mzk	
i-wak	iwk	
dehwari	deh	
tapeba	tbb	
palya bareli	bpx	
moni	mnz	
dholuo	luo	
bumbita arapesh	aon	
wusi	wsi	
nemi	nem	
pidgin english	cpi	gpe	
mócheno	mhn	
eastern highland otomi	otm	
tikopia	tkp	
barama	bbg	
kosadle	kiq	
pholo	yip	
kumukio	kuo	
chak	ckh	
alsea	aes	
kolibugan subanon	skn	
wè southern	gxx	
burun	bdi	
laka (nigeria)	lak	
ghale	ghe	ghh	ght	
guernésiais	nrf	
maricopa	mrc	
duguri	dbm	
buso	bso	
mahou	mxx	
mongol	mgt	
marsian	ims	
a-pucikwar	apq	
toro tegu dogon	dtt	
suruí do pará	mdz	
alacatlatzala mixtec	mim	
kasem	xsm	
malay	abs	bpq	btj	bve	bvu	coa	jax	lrt	max	mbf	meo	mfa	mfp	mhp	mkn	mqg	msi	pmy	pse	vkt	xmm	zsm	mly	
chuanqiandian cluster miao	cqd	
konzo	koo	
tomini	txm	
adilabad gondi	wsg	
kusaal	kus	
kisar	kje	
bilba	bpz	
bondum dom dogon	dbu	
sundanese	sun	
bulu (cameroon)	bum	
kais	kzm	
nanai	gld	
margi	mrt	
tolowa	tol	
urim	uri	
eastern gorkha tamang	tge	
wangkumara	xwk	nbx
teke-fuumu	ifm	
cabiyarí	cbb	
cuicatec	cut	cux	
busa	bqp	
kono (sierra leone)	kno	
mushungulu	xma	
noone	nhu	
toda	tcx	
mocoví	moc	
sorbian	dsb	hsb	
karko	kko	
kott	zko	
somali	som	
kalanadi	wkl	
akuntsu	aqz	
western xwla gbe	xwl	
wayuu	guc	
duwet	gve	
honduras sign language	hds	
akwa	akw	
uare	ksj	
guerrero nahuatl	ngu	
northern rengma naga	nnl	
mapoyo	mcg	
toro	tdv	
tawr chin	tcp	
shumashti	sts	
phai	prt	
seimat	ssg	
mayeka	myc	
svenska	swe	
acheron	acz	
páez	pbb
Antekerrepenhe	aer
nez perce	nez	
minaean	inm	
fang (cameroon)	fak	
nama (papua new guinea)	nmx	
darai	dry	
huichol	hch	
lasalimu	llm	
martuyhunira	vma	
ifè	ife	
valle nacional chinantec	cvn	
alu kurumba	xua	
petats	pex	
murrinh-patha	mwf	
marithiel	mfr	
gbayi	gyg	
odiai	bhf	
girawa	bbr	
duke	nke	
gambera	gma	
umiida	xud	
kirghiz	kir	
tese	keg	
saint lucian creole french	acf	
balochi	bcc	bgn	bgp	
guragone	gge	
zay	zwa	
ketum	ktt	
chaga	jmc	
ayta	abc	abp	ays	ayt	ayy	blx	sgb	
dengese	dez	
gudang	xgd	
salchuq	slq	
pattapu	ptq	
olumarama	lrm	
sewa bay	sew	
sochiapam chinantec	cso	
mongolia buriat	bxm	
manna-dora	mju	
sichuan yi	iii	
coatecas altas zapotec	zca	
slave	scs	
cameroon pidgin	wes	
assangori	sjg	
babungo	bav	
moloko	mlw	
salas	sgu	
kanikkaran	kev	
lindu	klw	
duhwa	kbz	
pannei	pnc	
nubaca	baf	
catalonian sign language	csc	
qabiao	laq	
chenoua	cnu	
tilung	tij	
sou	sqq	
guwamu	gwu	
tandaganon	tgn	
waru	wru	
chilean sign language	csg	
kaningdon-nindem	kdp	
gusii	guz	
tunni	tqq	
krymchak	jct	
maringarr	zmt	
ufim	ufi	
ili'uun	ilu	
daungwurrung	dgw	
tamazight	tia	tjo	tzm	zgh	
awad bing	bcu	
yalunka	yal	
batek	btq	
tupinambá	tpn	
iaai	iai	
sowa	sww	
rawat	jnl	
penrhyn	pnh	
vao	vao	
malay (macrolanguage)	msa	
nyelâyu	yly	
middle english (1100-1500)	enm	
jita	jit	
yawiyo	ybx	
baelelea	bvc	
bakwé	bjw	
chichicapan zapotec	zpv	
okpamheri	opa	
extremaduran	ext	
biangai	big	
yanyuwa	jao	
ampanang	apg	
topoiyo	toy	
karaboro	kza	xrb	
rahambuu	raz	
imroing	imr	
halh mongolian	khk	
wali (sudan)	wll	
agob	kit	
himarimã	hir	
kele (democratic republic of congo)	khy	
isthmus mixe	mir	
lengua de señas del paraguay	pys	
shubi	suj	
rungus	drg	
kaamba	xku	
basque	eus	
ywom	gek	
lutos	ndy	
mbole	mdq	
lacandon	lac	
cafundo creole	ccd	
luwati	luv	
ama (papua new guinea)	amm	
jamaican country sign language	jcs	
mak (china)	mkg	
ts'ün-lao	tsl	
laru	lan	
cayuga	cay	
indus kohistani	mvy	
camunic	xcc	
badeshi	bdz	
duna	duc	
sangil	snl	
north moluccan malay	max	
tz'utujil	tzj	
yangman	jng	
cheyenne	chy	
yugambal	yub	
yirandali	ljw	
tombelala	ttp	
rama	rma	
ndzwani comorian	wni	
kamas	xas	
damar	dmr	drn	
gikuyu	kik	
karore	xkx	
youjiang zhuang	zyj	
san luís temalacayuca popoloca	pps	
punan tubu	puj	
gadjerawang	gdh	
temuan	tmw	
o'du	tyh	
tai nüa	tdd	
nubian	onw	
chalikha	tgf	
dyirbal	dbl	
siliput	mkc	
agavotaguerra	avo	
lautu chin	clt	
huaylla wanca quechua	qvw	
tebul ure dogon	dtu	
jilbe	jie	
wuliwuli	wlu	
bina (papua new guinea)	bmn	
kirike	okr	
narim	loh	
baham	bdw	
neko	nej	
delaware	del	dep	
yinggarda	yia	
cineni	cie	
barbacoas	bpb	
gelao	giq	gir	giw	
bangi	bni	
mapudungun	arn	
valpei	vlp	
eastern bru	bru	
iamalele	yml	
ju/'hoan	ktz	
poke	pof	
etulo	utr	
morom	bdo	
tolaki	lbw	
mlabri	mra	
north alaskan inupiatun	esi	
pass valley yali	yac	
sikaiana	sky	
chazumba mixtec	xtb	
nomlaki	nol	
pinotepa nacional mixtec	mio	
kosena	kze	
kurti	ktm	
northern haida	hdn	
buyuan jinuo	jiy	
yirrk-mel	yrm	
asilulu	asl	
kituba (congo)	mkw	
xhosa	xho	
southern subanen	laa	
umbugarla	umr	
shawnee	sjw	
curonian	xcu	
mbesa	zms	
tupinikin	tpk	
bomwali	bmw	
nafusi	jbn	
shoshoni	shh	
baba	bbw	
east masela	vme	
simbo	sbb	
pottangi ollar gadaba	gdb	
rogo	rod	
kapya	klo	
keapara	khz	
winyé	kst	
koho	kpm	
awyu	aws	awu	awv	awy	psa	yir	
urigina	urg	
jingpo	kac	
oroha	ora	
eastern pomo	peb	
kaikadi	kep	
deutsch	deu	
macaguaje	mcl	
green gelao	giq	
budza	bja	
yosondúa mixtec	mpm	
cocama-cocamilla	cod	
sauria paharia	mjt	
xetá	xet	
nayi	noz	
mongo	lol	
sonsorol	sov	
tugen	tuy	
bunama	bdd	
karuwali	rxw	
samatao	ysd	
amara	aie	
michoacán nahuatl	ncl	
tamang	taj	tdg	tge	tmk	
xiang chinese	hsn	
yi	iii	yix	ylo	ywq	
dhungaloo	dhx	
nomaande	lem	
aghu	ahh	
sheng	swh	
guanche	gnc	
joba	job	
northern one	onr	
sudovian	xsv	
ringgou	rgu	
slovakian sign language	svk	
gvoko	ngs	
parsi-dari	prd	
hamtai	hmt	
bodo (central african republic)	boy	
palawano	plc	plv	plw	
simba	sbw	
kei	kei	
idon	idc	
old high german (ca. 750-1050)	goh	
gula'alaa	gmb	
tenango otomi	otn	
kelo	xel	
warrgamay	wgy	
mayogo	mdm	
kazukuru	kzk	
west coast bajau	bdr	
kyrgyz	kir	
sicilian	scn	
texistepec popoluca	poq	
numbami	sij	
anyin	any	
opuuo	lgn	
amami-oshima	ams	ryn	
jabutí	jbt	
ak	akq	
lepcha	lep	
gupapuyngu	guf	
northern tujia	tji	
doondo	dde	
baré	bae	
bena (nigeria)	yun	
daka	ccg	
karingani	kgn	
hunnic	xhc	
nuer	nus	
mada (nigeria)	mda	
uamué	uam	
mbugu	mhd	
bumthangkha	kjz	
mainfränkisch	vmf	
tutelo	tta	
karitiâna	ktn	
tai ya	cuu	
kalaallisut	kal	
mer	mnu	
lihir	lih	
swabian	swg	
walmajarri	wmt	
daonda	dnd	
misima-panaeati	mpx	
karagas	kim	
waray (australia)	wrz	
towei	ttn	
kono (nigeria)	klk	
kaytetye	gbb	
yawalapití	yaw	
australian aborigines sign language	asw	
gula iro	glj	
chuj	cac	
ngayawung	nwg	
adiwasi garasia	gas	
yimchungru naga	yim	
afitti	aft	
kamang	woi	
tasawaq	twq	
kyak	bka	
matís	mpq	
warluwara	wrb	
tareng	tgr	
fuyug	fuy	
xokleng	xok	
northern sotho	nso	
senthang chin	sez	
kinabatangan	dmg	
yukaghir	ykg	yux	
carolina algonquian	crr	
baybayanon	bvy	
mangbutu	mdk	
eastern katu	ktv	
mahican	mjy	
tunggare	trt	
manobo	atd	mbb	mbd	mbi	mbs	mbt	mkx	mqk	msm	mta	obo	
yabarana	yar	
teop	tio	
yombe	yom	
west goodenough	ddi	
viti	vit	
mbe'	mtk	
yucatec mayan	yua	
nishnaabemwin	otw	
koongo	kng	
kanauji	bjj	
eastern huishui miao	hme	
tarifit	rif	
lavrung	jiq	
rajbanshi	rjs	
mamuju	mqx	
mixtec	jmx	mab	mbz	mce	mdv	meh	mib	mie	mig	mih	mii	mil	mim	mio	mip	mit	miu	mix	miy	miz	mjc	mks	mpm	mqh	mtu	mtx	mvg	mxa	mxb	mxs	mxt	mxv	mxy	mza	vmc	vmj	vmm	vmq	vmx	xta	xtb	xtd	xti	xtj	xtl	xtm	xtn	xtp	xts	xtt	xtu	xty	
iduna	viv	
rotuman	rtm	
phowa	yhl	ypb	ypn	
kawe	kgb	
zuojiang zhuang	zzj	
sranan	srn	
jamsay dogon	djm	
bonerate	bna	
seko padang	skx	
sowari	dmy	
awing	azo	
taupota	tpa	
ngbundu	nuu	
indonesian	ind	pea	
cebaara senoufo	sef	
talaandig	bkd	
harsusi	hss	
ona	ona	
fyam	pym	
gothic	got	
shekhawati	swv	
ixtayutla mixtec	vmj	
bannoni	bcm	
koalib	kib	
adasen	tiu	
lauje	law	
kanga	kcp	
standard estonian	ekk	
manda (tanzania)	mgs	
walungge	ola	
angolar	aoa	
k'ichee'	quc	
northern tiwa	twf	
nagarchal	nbg	
bamunka	bvm	
harzani	hrz	
welsh	cym	owl	wlm	
mezquital otomi	ote	
creole french	acf	crs	gcf	gcr	kmv	rcf	scf	
mazaltepec zapotec	zpy	
koy sanjaq surat	kqd	
croatian	hrv	
yahuna	ynu	
northern bai	bfc	
noiri	noi	
central sama	sml	
kulfa	kxj	
garus	gyb	
azoyú me'phaa	tpc	
bemba	bem	
algerian sign language	asp	
nawaru	nwr	
green hmong	blu	
jofotek-bromnya	jbr	
xadani zapotec	zax	
chincha quechua	qxc	
dhuwaya	dwy	
ghari	gri	
alladian	ald	
tuvinian	tyv	
maiwala	mum	
mundat	mmf	
=/hua	huc	
karata	kpt	
daur	dta	
old occitan (to 1500)	pro	
koenoem	kcs	
gheg albanian	aln	
orejón	ore	
kolbila	klc	
itik	itx	
to'abaita	mlu	
vinza	vin	
woods cree	cwd	
pawaia	pwa	
classical tibetan	xct	
mala (papua new guinea)	ped	
congo swahili	swc	
ho-chunk	win	
nyabwa	nwb	
wymysorys	wym	
jerung	jee	
bo-rukul	mae	
yong	yno	
utarmbung	omo	
ngwe	nwe	
babango	bbm	
angami naga	njm	
emilian	egl	
dorig	wwo	
biloxi	bll	
domari	rmt	
vamale	mkt	
tocantins asurini	asu	
flaaitaal	fly	
yagara	yxg	
mapia	mpy	
central pashto	pst	
amba (uganda)	rwm	
kangjia	kxs	
putukwam	afe	
old burmese	obr	
sinhalese	sin	
njerep	njr	
lingua franca nova	lfn	
tunzu	dza	
north nuaulu	nni	
retta	ret	
bisaya	bsb	bsy	
dama	dmm	
irigwe	iri	
karok	kyh	
hermit	llf	
old avar	oav	
otomi	ote	otl	otm	otn	otq	ots	ott	otx	otz	
ngardi	rxd	
iha	ihp	
sikaritai	tty	
northeastern dinka	dip	
logorik	liu	
korak	koz	
songoora	sod	
kaniet	ktk	
mele-fila	mxe	
songhay	hmb	khq	
suarmin	seo	
hernican	xhr	
lachi	lbt	lwh	
hiberno-scottish gaelic	ghc	
prākrit	pka	pmh	psu	
boselewa	bwf	
karranga	xrq	
cebuano	ceb	
koyo	koh	
lalana chinantec	cnl	
khotanese	kho	
efutop	ofu	
kahe	hka	
pinyin	pny	
aputai	apx	
northern luri	lrc	
gorakor	goc	
umbindhamu	umd	
southeastern puebla nahuatl	npl	
isoko	iso	
komodo	kvh	
wané	hwa	
mt. iraya agta	atl	
ngelima	agh	
san jerónimo tecóatl mazatec	maa	
pallanganmiddang	pmd	
kol (papua new guinea)	kol	
ido	ido	
bavarian	bar	
lower ta'oih	tto	
aoheng	pni	
kwerba	kwe	
mayi-kulan	xyk	
rarotongan	rar	
koch	kdq	
nyamwezi	nym	
tsuvadi	tvd	
bolgo	bvo	
abau	aau	
tingui-boto	tgv	
kuikúro-kalapálo	kui	
kamarian	kzx	
mesmes	mys	
ukuriguma	ukg	
arikem	ait	
chatino	cly	cta	ctp	ctz	cya	czn	
upper grand valley dani	dna	
ibanag	ibg	
kotava	avk	
kwamera	tnk	
kavet	krv	
luimbi	lum	
talinga-bwisi	tlj	
tai hongjin	tiz	
moklen	mkm	
tal	tal	
yerong	yrn	
tai thanh	tmm	
giangan	bgi	
pacoh	pac	
japrería	jru	
huitoto	hto	huu	hux	
sepa (papua new guinea)	spe	
wunambal	wub	
western sisaala	ssl	
arequipa-la unión quechua	qxu	
shatt	shj	
ukhwejo	ukh	
haruku	hrk	
maklew	mgf	
andai	afd	
marwari (pakistan)	mve	
lole	llg	
adithinngithigh	dth	
southern pastaza quechua	qup	
narungga	nnr	
birri	bvq	
southern roglai	rgs	
sirmauri	srx	
lijili	mgi	
kusunda	kgg	
dharuk	xdk	
galo	adl	
iceve-maci	bec	
south giziga	giz	
botlikh	bph	
ndogo	ndz	
maco	wpc	
karaim	kdr	
boro (ethiopia)	bwo	
mahasu pahari	bfz	
chiquihuitlán mazatec	maq	
senoufo	dyi	myk	plr	seb	sef	sev	shz	spp	tgw	
megleno romanian	ruq	
avaric	ava	
mor (mor islands)	mhz	
atatláhuca mixtec	mib	
pe	pai	
blagar	beu	
wajarri	wbv	
oku	oku	
loma (liberia)	lom	
lahta karen	kvt	
wayanad chetti	ctt	
kambera	xbr	
tontemboan	tnt	
arawak	arw	
nakara	nck	
hasha	ybj	
majhwar	mmj	
baoulé	bci	
algerian saharan arabic	aao	
lelak	llk	
gule	gly	
tai yo	tyj	
wongo	won	
bhujel	byh	
yurats	rts	
waigali	wbk	
aizi	ahi	ahm	ahp	
bamali	bbq	
vame	mlr	
toma	tod	
guajá	gvj	
mundari	unr	muw	
tonkawa	tqw	
north asmat	nks	
east berawan	zbe	
mingang doso	mko	
nafri	nxx	
parauk	prk	
totela	ttl	
principense	pre	
birale	bxe	
pichis ashéninka	cpu	
gafat	gft	
lama bai	lay	
efate	erk	llp	
apinayé	apn	
waigeo	wgo	
dawro	dwr	
keijar	kdy	
sindhi bhil	sbn	
maria	daq	
ayere	aye	
zacatepec chatino	ctz	
maquiritari	mch	
northern binukidnon	kyn	
mazahua	maz	mmc	
beti (côte d'ivoire)	eot	
judeo-berber	jbe	
lau	llu	
tepinapa chinantec	cte	
wiarumus	tua	
lengua de señas catalana	csc	
bodo gadaba	gbj	
bhattiyali	bht	
bayot	bda	
onobasulu	onn	
hittite	hit	htx	nei	oht	
santa ana de tusi pasco quechua	qxt	
tlacolulita zapotec	zpk	
orokolo	oro	
nabay	kxi	
gwichʼin	gwi	
nukuoro	nkr	
haka chin	cnh	
jukun takum	jbu	
gamkonora	gak	
malango	mln	
businenge tongo	djk	
una	mtg	
ngawun	nxn	
croatia sign language	csq	
brem	buq	
maindo	cwb	
izon	ijc	
kuo	xuo	
ashéninka pajonal	cjo	
crow	cro	
manchu	mnc	
lakota	lkt	
runga	rou	
southwestern bontok	vbk	
ocotlán zapotec	zac	
labuk-kinabatangan kadazan	dtb	
southern aymara	ayc	
dzongkha	dzo	
central pomo	poo	
oro win	orw	
notsi	ncf	
karenggapa	eaa	
ipalapa amuzgo	azm	
morigi	mdb	
opao	opo	
tagbanwa	tbk	tbw	tgt	
sekpele	lip	
tavoyan	tvn	
ile ape	ila	
bhaya	bhe	
chiapanec	cip	
nigerian sign language	nsi	
north junín quechua	qvn	
saudi arabian sign language	sdl	
manyawa	mny	
tyap	kcg	
paynamar	pmr	
doe	doe	
ghera	ghr	
sô	sss	
kriol	rop	
dotyali	dty	
amharic	amh	
central grebo	grv	
tepecano	tep	
khamyang	ksu	
amanab	amn	
ponosakan	pns	
huizhou chinese	czh	
nawuri	naw	
kapinawá	xpn	
nepali	nep	
eastern lalu	yit	
andh	anr	
timbe	tim	
matigsalug manobo	mbt	
guwa	xgw	
duupa	dae	
jebero	jeb	
mohawk	moh	
tinputz	tpz	
litzlitz	lzl	
wikalkan	wik	
galibi carib	car	
hixkaryana	hix	
hung	hnu	
cao lan	mlc	
buru (indonesia)	mhs	
kalmyk	xal	
migum	klm	
duma	dma	
ikpeshi	ikp	
frisian	frr	frs	fry	ofs	fri	
tsakhur	tkr	
kamasa	klp	
tase naga	nst	
marshallese	mah	
chamorro	cha	
bariji	bjc	
dongo	doo	
secoya	sey	
bajan	bjs	
tewa	tew	
nambo	ncm	
egyptian arabic	arz	
bislama	bis	
buang	bzh	mmo	
huarijio	var	
katcha-kadugli-miri	xtc	
mayawali	yxa	
dameli	dml	
balaesang	bls	
yuanga	nua	
nari nari	rnr	
kuria	kuj	
russia buriat	bxr	
tinani	lbf	
ambo	amb	
kodia	kwp	
ninzo	nin	
tokelauan	tkl	
bhalay	bhx	
amto	amt	
kadazan	dtb	kqt	
northern tutchone	ttm	
vumbu	vum	
quiché	quc	
guhu-samane	ghs	
northwestern ojibwa	ojb	
southeastern kolami	nit	
eastern kayah	eky	
miwa	vmi	
bushi	buc	
aribwatsa	laz	
aguaruna	agr	
southeastern nochixtlán mixtec	mxy	
taromi	tov	
yambes	ymb	
limos kalinga	kmk	
northern paiute	pao	
itzá	itz	
biyom	bpm	
yelmek	jel	
chuvantsy	xcv	
creole dutch	brc	skw	
teutila cuicatec	cut	
xicotepec de juárez totonac	too	
chontal	chd	chf	clo	
northern bontok	rbk	
antankarana malagasy	xmv	
bago-kusuntu	bqg	
sanglechi	sgy	
kyerung	kgy	
changriwa	cga	
komi-zyrian	kpv	
wappo	wao	
tai daeng	tyr	
hinukh	gin	
chiga	cgg	
malayic dayak	xdy	
khmu	kjg	
bamu	bcf	
zapotec	xzp	zaa	zab	zac	zad	zae	zaf	zai	zam	zao	zap	zaq	zar	zas	zat	zav	zaw	zax	zca	zoo	zpa	zpb	zpc	zpd	zpe	zpf	zpg	zph	zpi	zpj	zpk	zpl	zpm	zpn	zpo	zpp	zpq	zpr	zps	zpt	zpu	zpv	zpw	zpx	zpy	zpz	zsr	zte	ztg	ztl	ztm	ztn	ztp	ztq	zts	ztt	ztu	ztx	zty	
kom (india)	kmm	
kimré	kqp	
para naga	pzn	
western xiangxi miao	mmr	
naami	bzv	
bangla	ben	
sindarin	sjn	
timne	tem	
waima'a	wmh	
egyptian (ancient)	egy	
lisabata-nuniali	lcs	
cross river mbembe	mfn	
toussian	tsp	wib	
kinyarwanda	kin	
maranao	mrw	
dendi (benin)	ddn	
sáliba	slc	
cayubaba	cyb	
central nicobarese	ncb	
middle newar	nwx	
kataang	kgd	
chachapoyas quechua	quk	
supyire senoufo	spp	
plautdietsch	pdt	
zenaga	zen	
borong	ksr	
lombard	lmo	
melo	mfx	
slavey	scs	xsl	
bebele	beb	
kala	kcl	
daantanai'	lni	
gail	gic	
kehu	khh	
circassian	ady	
komo (sudan)	xom	
pévé	lme	
tita	tdq	
gbaya	gso	gya	
kung-ekoka	knw	
mawak	mjj	
ilue	ilv	
ivbie north-okpela-arhe	atg	
martu wangka	mpj	
gurgula	ggg	
tigrinya	tir	
mpiemo	mcx	
baltic romani	rml	
old french (842-ca. 1400)	fro	
swiss-italian sign language	slf	
teke-kukuya	kkw	
ayacucho quechua	quy	
castilian	spa	
bariai	bch	
limburgan	lim	
awadhi	awa	
sénoufo	sen	sep	seq	
kulisusu	vkl	
lydian	xld	
lower grand valley dani	dni	
aiton	aio	
saxwe gbe	sxw	
simte	smt	
luri	ldd	lrc	luz	
hijazi arabic	acw	
gban	ggu	
ponyo-gongwang naga	npg	
morerebi	xmo	
sanggau	scg	
bafia	ksf	
kutang ghale	ght	
oraon sadri	sdr	
vano	vnk	
michigamea	cmm	
media lengua	mue	
sarangani blaan	bps	
ngalum	szb	
bangime	dba	
bun	buv	
opata	opt	
carib	car	crb	
maridjabin	zmj	
mwaghavul	sur	
karas	kgv	
dhaiso	dhs	
lowland oaxaca chontal	clo	
lowland tarahumara	tac	
sihan	snr	
nekgini	nkg	
walloon	wln	
weh	weh	
penchal	pek	
san marcos tlalcoyalco popoloca	pls	
guatemalan sign language	gsm	
tindi	tin	
leti (indonesia)	lti	
ikobi	meb	
malalamai	mmt	
mvuba	mxh	
e'ñapa woromaipu	pbh	
eastern hongshuihe zhuang	zeh	
southern grebo	grj	
duano	dup	
sassarese sardinian	sdc	
tachoni	lts	
mohegan-pequot	xpq	
malankuravan	mjo	
libinza	liz	
bliss	zbl	
mbwela	mfu	
nhirrpi	hrp	
umbu-ungu	ubu	
gooniyandi	gni	
bete	byf	
kahua	agw	
efai	efa	
degexit'an	ing	
old ossetic	oos	
kenyan sign language	xki	
mnong	cmo	mng	mnn	
galela	gbi	
tripuri	xtr	
tunjung	tjg	
southern kisi	kss	
eman	emn	
dayak	xdy	
ambul	apo	
mandobo bawah	bwp	
paraguayan guaraní	gug	
mawan	mcz	
chetti	ctt	
shuadit	sdt	
nyangumarta	nna	
carapana	cbc	
cao miao	cov	
scots	sco	
northern pame	pmq	
cuneiform luwian	xlu	
chengdu	iii	
barbareño	boi	
candoshi-shapra	cbu	
mwimbi-muthambi	mws	
khao	xao	
buol	blf	
mbato	gwa	
pathiya	pty	
apma	app	
nyamal	nly	
chepang	cdm	
ngalakgan	nig	
kayabí	kyz	
twana	twa	
kagan kalagan	kll	
bidyogo	bjg	
eastern bolivian guaraní	gui	
kayah	eky	kyu	
bainouk-samik	bcb	
southwest pashai	psh	
usila chinantec	cuc	
bwanabwana	tte	
yekhee	ets	
gboloo grebo	gec	
kohin	kkx	
nathembo	nte	
miship	mjs	
dhatki	mki	
bo (papua new guinea)	bpw	
mukha-dora	mmk	
bondo	bfw	
mawa (chad)	mcw	
southern pomo	peq	
stellingwerfs	stl	
male (ethiopia)	mdy	
southern puebla mixtec	mit	
rathwi bareli	bgd	
lamas kechwa	qvs	
ngamo	nbh	
geko karen	ghk	
southern kalapuya	sxk	
jakalteko	jac	
laiyolo	lji	
maba (chad)	mde	
ura (papua new guinea)	uro	
mapena	mnm	
pingelapese	pif	
janji	jni	
messapic	cms	
scythian	xsc	
kannada	kan	
khorasani turkish	kmz	
laua	luf	
ajiya	idc	
santa maría la alta nahuatl	nhz	
petapa zapotec	zpe	
orokaiva	okv	
edomite	xdm	
thawa	xtv	
xiriâna	xir	
min nan chinese	nan	
senaya	syn	
alak	alk	
tajuasohn	tja	
mandeali	mjl	
ontenu	ont	
ca̱hungwa̱rya̱	nat	
lashi	lsi	
osing	osi	
north babar	bcd	
uneapa	bbn	
old norse	non	
etruscan	ett	
simeulue	smr	
ibani	iby	
shina	plk	scl	
tabriak	tzx	
tagalog	tgl	
oki-no-erabu	okn	
timugon murut	tih	
gunwinggu	gup	
ga'anda	gqa	
middle low german	gml	
dolpo	dre	
limbu	lif	
mashi (nigeria)	jms	
kinande	nnb	
béte	bet	
kofei	kpi	
wasu	wsu	
assamese	asm	
bozaba	bzo	
mari	mhr	mrj	
inoke-yate	ino	
mor (bomberai peninsula)	moq	
alngith	aid	
lobirè	lob	
qaqet	byx	
dzando	dzn	
ubaghara	byc	
metlatónoc mixtec	mxv	
tuparí	tpr	
dupaninan agta	duo	
rapanui	rap	
hozo	hoz	
goodenough	ddi	
quetzaltepec mixe	pxm	
bian marind	bpv	
saniyo-hiyewe	sny	
chuka	cuh	
gaam	tbi	
yoy	yoy	
kewa	kew	kjs	
akhvakh	akv	
laimbue	lmx	
dghwede	dgh	
borgu fulfulde	fue	
kuranko	knk	
bumang	bvp	
barein	bva	
yanda	yda	
gorowa	gow	
mong leng	hnj	
southern east cree	crj	
achumawi	acv	
garza	xgr	
tamasheq	taq	
mampruli	maw	
tay khang	tnu	
catawba	chc	
pagibete	pae	
gula (chad)	glu	
ewe	ewe	
nyamusa-molo	nwm	
magar	mgp	mrd	
nukunul	xnu	
south fali	fal	
guibei zhuang	zgb	
bor	bxb	
juxtlahuaca mixtec	vmc	
aasáx	aas	
thaypan	typ	
lakha	lkh	
dhanwar (nepal)	dhw	
ndunda	nuh	
northwestern !kung	vaj	
glio-oubi	oub	
gwere	gwr	
ganang	gne	
mauwake	mhl	
aproumu aizi	ahp	
nupe	nup	
avá-canoeiro	avv	
dene suline	chp	
southern lolopo	ysp	
tuma-irumu	iou	
hewa	ham	
chini	afi	
bugun	bgg	
kerinci	kvr	
myene	mye	
birifor	bfo	biv	
kimaghima	kig	
bikya	byb	
dabe	dbe	
mussau-emira	emi	
narua	nru	
north tanna	tnn	
baruya	byr	
bobo madaré	bbo	bwq	
abidji	abi	
jiarong	jya	
mandaya	mry	
zoque	zoc	zoh	zoq	zor	zos	
bamako sign language	bog	
bukit malay	bvu	
uma' lung	ulu	
central lalo	ywt	
punjabi	pan	
hehe	heh	
domaaki	dmk	
early high german	mis	
gane	gzn	
sampang	rav	
sotho	nso	sot	
tilapa otomi	otl	
gabri	gab	
western kayah	kyu	
naro	nhr	
pataxó hã-ha-hãe	pth	
phudagi	phd	
atta	atp	att	azt	
blablanga	blp	
vitou	vto	
kwere	cwe	
chinese	cdo	cjy	cmn	cpx	czh	czo	gan	hak	hsn	ltc	lzh	mnp	nan	och	wuu	yue	zho	
chichimeca-jonaz	pei	
laopang	lbg	
mamaindé	wmd	
chukchi	ckt	
tukang besi south	bhq	
mixed great andamanese	gac	
sinte romani	rmo	
tagoi	tag	
southern sierra miwok	skd	
chetco	ctc	
west greenlandic	kal	
wabo	wbb	
molbog	pwm	
tombonuo	txa	
chocangacakha	cgk	
upper necaxa totonac	tku	
kaninuwa	wat	
bozo	boo	boz	bze	bzx	
arawá	aru	
warungu	wrg	
ndali	ndh	
boma	boh	
wae rana	wrx	
gbaya (central african republic)	gba	
cheq wong	cwg	
southern guiyang miao	hmy	
yang zhuang	zyg	
karo (brazil)	arr	
tawbuid	bnj	twb	
kisi	kiz	kss	
gros ventre	ats	
caribbean hindustani	hns	
shilluk	shk	
puyuma	pyu	
dungra bhil	duh	
shom peng	sii	
nkoroo	nkx	
petalcingo tzeltal	tzb	
safeyoka	apz	
naukan yupik	ynk	
idere	ide	
zhuang	zch	zeh	zgb	zgm	zgn	zha	zhd	zhn	zlj	zln	zlq	zqe	zyb	zyg	zyj	zyn	zzj	ccx	
ama (sudan)	nyi	
moroccan sign language	xms	
airoran	air	
hungworo	nat	
morisyen	mfe	
nganyaywana	nyx	
esimbi	ags	
surbakhal	sbj	
eastern lawa	lwl	
khengkha	xkf	
langi	lag	laj	
sakao	sku	
angal	age	
oroqen	orh	
guinea kpelle	gkp	
makian	mky	mqs	
western subanon	suc	
idu-mishmi	clk	
alyawarr	aly	
tampulma	tpm	
dzao min	bpn	
eastern maroon creole	djk	
rudbari	rdb	
old japanese	ojp	
waskia	wsk	
knaanic	czk	
baniwa	bwi	
amurdak	amg	
samaritan	smp	
mauritian sign language	lsy	
nzima	nzi	
jumli	jml	
embu	ebu	
basap	bdb	
marma	rmz	
jorá	jor	
lahta	kvt	
cheremis	mhr	
cinta larga	cin	
mbe	mfo	
bayono	byl	
filomena mata-coahuitlán totonac	tlp	
geruma	gea	
corongo ancash quechua	qwa	
kayan mahakam	xay	
beeke	bkf	
ngemba	nge	
hdi	xed	
lagwan	kot	
mbugwe	mgz	
wampanoag	wam	
kaluli	bco	
nete	net	
chitimacha	ctm	
dacian	xdc	
yuhup	yab	
kaonde	kqn	
izere	izr	
nobiin	fia	
koba	kpd	
brazilian portuguese	por	
kayapa kallahan	kak	
mobwa karen	jkm	
southern betsimisaraka malagasy	bzc	
sebop	sib	
benggoi	bgy	
bagheli	bfy	
chilisso	clh	
khanty	kca	
yout wam	ytw	
albanian	aae	aat	aln	als	sqi	
paama	pma	
haji	hji	
puruborá	pur	
ugaritic	uga	
eskimo	kal	
karami	xar	
shempire senoufo	seb	
korubo	xor	
khorezmian	zkh	
sayula popoluca	pos	
themne	tem	
katua	kta	
kafoa	kpu	
bigambal	xbe	
traveller norwegian	rmg	
tsishingini	tsw	
sapé	spc	
yaeyama	rys	
konyanka maninka	mku	
san francisco del mar huave	hue	
czech sign language	cse	
tumi	kku	
narango	nrg	
popoloca	pbe	pbf	pca	pls	poe	pow	pps	
mawukakan	mxx	
pande	bkj	
defi gbe	gbh	
wanggamala	wnm	
begbere-ejar	bqv	
beng	nhb	
yatee zapotec	zty	
arumanian	rup	
patamona	pbc	
wa'ema	wag	
mendankwe-nkwen	mfd	
slavic	chu	
older english	ang	
zhaba	zhb	
bonggi	bdg	
gnau	gnu	
geez	gez	
wutunhua	wuh	
dendi (central african republic)	deq	
dhanki	dhn	
ganzi	gnz	
palauan	pau	
doyayo	dow	
north russian romani	rml	
kwoma	kmo	
tem	kdh	
inari sami	smn	
reel	atu	
aranama-tamique	xrt	
dungmali	raa	
southwestern tepehuan	tla	
panoan katukína	knt	
umiray dumaget agta	due	
kalo finnish romani	rmf	
kwaio	kwd	
kutep	kub	
löyöp	urr	
ekpeye	ekp	
ososo	oso	
koyukon	koy	
sinhala	sin	
burmeso	bzu	
khamba	kbg	
ketengban	xte	
zoogocho zapotec	zpq	
askopan	eiv	
ngando (central african republic)	ngd	
trió	tri	
eastern cham	cjm	
vestinian	xvs	
ngaju	nij	
asheninca campa	cpu	
ekari	ekg	
irish sign language	isg	
ngomba	jgo	
pirriya	xpa	
djinba	djb	
maaka	mew	
fedan	pdn	
cashinahua	cbs	
mozambican sign language	mzy	
mparntwe arrernte	aer	
berti	byt	
western bru	brv	
central mnong	cmo	
tiwa	lax	tix	twf	
jungle inga	inj	
mazatlán mazatec	vmz	
guinean sign language	gus	
southern guiyang hmong	hmy	
paiute	pao	
mmaala	mmu	
hungarian sign language	hsh	
tadaksahak	dsq	
kaibobo	kzb	
lele (papua new guinea)	lle	
turoyo	tru	
tumulung sisaala	sil	
ná-meo	neo	
kamo	kcq	
laari	ldi	
kenyi	lke	
sherpa	xsr	
momare	msz	
evenki	evn	
erave	kjy	
northern nuni	nuv	
baha buyang	yha	
pech	pay	
barrow point	bpt	
davawenyo	daw	
choapan zapotec	zpc	
quiavicuzas zapotec	zpj	
andio	bzb	
toura (côte d'ivoire)	neb	
citak	tml	txt	
te'un	tve	
uneme	une	
qila muji	ymq	
diuwe	diy	
bora	boa	
ngwaba	ngw	
mbangwe	zmn	
agatu	agc	
karbi	ajz	mjw	
santali	sat	
ana tinga dogon	dti	
ta'izzi-adeni arabic	acq	
khlula	ykl	
tetun dili	tdt	
nyaneka	nyk	
forest enets	enf	
ikwere	ikw	
sochiapan chinantec	cso	
muinane	bmr	
geman deng	mxj	
ruching palaung	pce	
danau	dnu	
north muyu	kti	
ushojo	ush	
chhintange	ctn	
tichurong	tcn	
rejang	rej	
zeeuws	zea	
vengo	bav	
dolgan	dlg	
seroa	kqu	
nyungwe	nyu	
ngbaka	nga	
rempi	rmp	
lishana deni	lsd	
hoava	hoa	
birao	brr	
western apache	apw	
western arrarnta	are	
yanahuanca pasco quechua	qur	
alanic	xln	
kyanga	tye	
mbala	mdp	
nenge	djk	
apali	ena	
ma manda	skc	
uzekwe	eze	
karen	blk	bwe	ghk	jkm	jkp	kjp	kjt	ksw	kvq	kvt	kvu	kvy	kxf	kxk	pwo	pww	
papar	dpp	
rawngtu chin	weu	
bokobaru	bus	
garig-ilgar	ilg	
songe	sop	
brazilian sign language	bzs	
churahi	cdj	
sheni	scv	
zokhuo	yzk	
benyadu'	byd	
uma' lasan	xky	
chantyal	chx	
tetum	tet	
santa catarina albarradas zapotec	ztn	
bauria	bge	
kola	kvv	
kitan	zkt	
baan	bvj	
pará gavião	gvp	
huambisa	hub	
tsetsaut	txc	
bulgarian sign language	bqn	
yis	yis	
zhire	zhi	
quiotepec chinantec	chq	
telefol	tlf	
pohnpeian	pon	
kariya	kil	
mser	kqx	
olo	ong	
busoa	bup	
ririo	rri	
akum	aku	
suba	sxb	
dutton world speedwords	dws	
ani phowa	ypn	
wanbasana	alw	
qau	gqu	
manangkari	znk	
dagbani	dag	
masana	mcn	
nanga dama dogon	nzz	
gugu warra	wrw	
tucano	tuo	
ocotepec zapotec	ztu	
basketo	bst	
kalagan	kll	kqe	
warkay-bipim	bgv	
label	lbb	
dororo	drr	
purepecha	pua	tsz	
hovongan	hov	
kaningi	kzo	
plains miwok	pmw	
kuku-uwanh	uwa	
western dani	dnw	
hopi	hop	
north watut	una	
afrikaans	afr	
koromira	kqj	
libyan arabic	ayl	
minidien	wii	
xamtanga	xan	
lomavren	rmi	
southeastern dinka	dks	
inupiatun	esi	esk	
teke-tsaayi	tyi	
iwur	iwo	
waddar	wbq	
kongo	kon	kwy	
karanga	kth	
olrat	olr	
ambrym	mmg	tvk	
awabakal	awk	
kamwe	hig	
median	xme	
imonda	imn	
elip	ekm	
sorothaptic	sxo	
ipili	ipi	
lambayeque quechua	quf	
romanian	ron	ruo	rup	ruq	
masmaje	mes	
tami	tmy	
arawum	awm	
igbo	ibo	
inapang	mzu	
bhil	sbn	
cishingini	asg	
tijaltepec mixtec	xtl	
aka-jeru	akj	
sighu	sxe	
ekit	eke	
maek	hmk	
adele	ade	
bauwaki	bwk	
biatah bidayuh	bth	
xibe	sjo	
eleme	elm	
wakawaka	wkw	
pancana	pnp	
marquesan	mqm	mrq	
old english (ca. 450-1100)	ang	
swati	ssw	
haigwai	hgw	
morori	mok	
diyari	dif	
western meohang	raf	
cora	cok	crn	
talysh	tly	
liana-seti	ste	
doga	dgg	
hre	hre	
suundi	sdj	
mator	mtm	
ut-ma'in	gel	
agi	aif	
ati	atk	
kimki	sbt	
ngunawal	xul	
tremembé	tme	
wagaya	wga	
mangole	mqc	
kildin sami	sjd	
nafi	srf	
piya-kwonci	piy	
pennsylvania german	pdc	
hunsrik	hrx	
urartian	xur	
ayizo gbe	ayb	
sagalla	tga	
jurchen	juc	
tày	tyz	
sukur	syk	
mburku	bbt	
dedua	ded	
aribwaung	ylu	
lama (togo)	las	
middle watut	mpl	
romagnol	rgn	
sumariup	siv	
yetfa	yet	
burji	bji	
mombo dogon	dmb	
southern dagaare	dga	
mazatlán mixe	mzl	
michoacán mazahua	mmc	
dungu	dbv	
levuka	lvu	
sami	sia	sjd	sje	sjk	sjt	sju	sma	sme	smn	sms	
elotepec zapotec	zte	
igala	igl	
ngungwel	ngz	
sinagen	siu	
kanyok	kny	
old french	fro	
khetrani	xhe	
malo	mla	
puoc	puo	
gun	guw	
koonzime	ozm	
tamahaq	thv	
lish	lsh	
cauca	cca	
caramanta	crf	
kuna	cuk	kvn	
gadaba	gau	gbj	gdb	
bofi	bff	
egypt sign language	esl	
vlaamse gebarentaal	vgt	
andaman creole hindi	hca	
rayón zoque	zor	
mufian	aoj	
kerek	krk	
zaramo	zaj	
wayana	way	
hanunoo	hnn	
mengaka	xmg	
darmiya	drd	
kalaktang monpa	kkf	
wemale	weo	
sidetic	xsd	
latvian sign language	lsl	
rohingya	rhg	
ankave	aak	
wakoná	waf	
iwal	kbm	
iyo	nca	
asas	asd	
kouya	kyf	
tsat	huq	
banda-mbrès	bqk	
dhivehi maldivian	div	
faita	faj	
gbanziri	gbg	
kathu	ykt	
birgit	btf	
sar	mwm	
kujarge	vkj	
kajaman	kag	
dogosé	dos	
bungu	wun	
suri	suq	
bole	bol	
kabore one	onk	
lungga	lga	
dzùùngoo	dnn	
koroshi	ktl	
adangme	ada	
turaka	trh	
dzamba	kng	
central nahuatl	nhn	
sowanda	sow	
armazic	xrm	
old kentish sign language	okl	
kanjari	kft	
baangi	bqx	
tirahi	tra	
mbelime	mql	
sa'och	scq	
inor	ior	
banam bay	vrt	
seke (nepal)	skj	
tairora	omw	tbg	
southeast ijo	ijs	
kachin	kac	
berik	bkl	
akeu	aeu	
meyah	mej	
waray (philippines)	war	
vwanji	wbi	
oriya (macrolanguage)	ori	
kire	geb	
ladji ladji	llj	
nzanyi	nja	
gbiri-niragu	grh	
dimli (individual language)	diq	
maranunggu	zmr	
inonhan	loc	
sunwar	suz	
macuna	myy	
south watut	mcy	
arbore	arv	
gamo	gmv	
phukha	phh	
arrernte	aer	
daloa bété	bev	
ute-southern paiute	ute	
sabu	hvn	
mbre	mka	
buriat	bua	bxm	bxr	bxu	
musgu	mug	
awngi	awn	
aruek	aur	
kabatei	xkp	
tchitchege	tck	
totoli	txe	
tehit	kps	
burmese	mya	obr	
shuar	jiv	
adamawa fulfulde	fub	
fataleka	far	
porohanon	prh	
small flowery miao	sfm	
rangpuri	rkt	
butmas-tur	bnr	
kwamtim one	okk	
jacaltec	jai	
yugoslavian sign language	ysl	
ledo kaili	lew	
muratayak	asx	
south ndebele	nbl	
yalahatan	jal	
bo (laos)	bgl	
quechua cusco	quz	
kaur	vkk	
yaka (congo)	iyx	
marathi	mar	omr	
loarki	lrk	
zan gula	zna	
nyiha (tanzania)	nih	
simeku	smz	
kanju	kbe	
jamaican	jam	
ninam	shb	
atampaya	amz	
zulgo-gemzek	gnd	
mahali	mjx	
melanau	dro	kxn	mel	sdx	
nyankpa	yes	
lampung api	ljp	
hlersu	hle	
koma	kmy	
tuyuca	tue	
bassossi	bsi	
wãpha	juw	
celtiberian	xce	
oorlams	oor	
mbum	mdd	
phu thai	pht	
heiltsuk	hei	
ayoquesco zapotec	zaf	
ayabadhu	ayd	
olutsotso	lto	
jalkunan	bxl	
tagin	tgj	
sherbro	bun	
margos-yarowilca-lauricocha quechua	qvm	
bangba	bbe	
tanimuca-retuarã	tnc	
lele (democratic republic of congo)	lel	
guiqiong	gqi	
groma	gro	
umatilla	uma	
ndendeule	dne	
irish	gle	mga	pgl	sga	
kabutra	kbu	
denya	anv	
gumuz	guk	
west masela	mss	
modang	mxd	
ossetian	oss	
maonan	mmd	
maku'a	lva	
car nicobarese	caq	
ndra'ngith	dgt	
ozumacín chinantec	chz	
mambae	mgm	
lobi	lob	
zangwal	zah	
pongu	png	
veps	vep	
chodri	cdi	
gadang	gdk	
azerbaijani	azb	aze	azj	
coos	csz	
thangal naga	nki	
slavomolisano	svm	
kanum	kcd	khd	krz	kxq	
kochila tharu	thq	
chachi	cbi	
jawe	jaz	
ngando (democratic republic of congo)	nxd	
naaba	nao	
pa di	pdi	
likuba	kxx	
kariyarra	vka	
kamula	xla	
nkem-nkum	isi	
türk i̇şaret dili	tsm	
maiani	tnh	
hértevin	hrt	
illyrian	xil	
yaqui	yaq	
horned miao	hrm	
chokri naga	nri	
fongoro	fgr	
south bavarian	bar	
kurichiya	kfh	
narragansett	xnt	
dargwa	dar	
kwanyama	kua	
apiaká	api	
irántxe	irn	
western muria	mut	
algerian arabic	arq	
northern sorsoganon	bks	
kato	ktw	
amblong	alm	
rao	rao	
blissymbols	zbl	
lembata	lmf	lmj	
ndam	ndm	
fernando po creole english	fpe	
san mateo del mar huave	huv	
brooke's point palawano	plw	
tuwari	tww	
bateri	btv	
khazar	zkz	
mansi	mns	
pankararú	paz	
baeggu	bvd	
mofu	mfk	
kala lagaw ya	mwp	
amarakaeri	amr	
cree	cre	crj	crk	crl	crm	csw	cwd	
tafi	tcd	
western kanjobal	knj	
bangolan	bgj	
moskona	mtj	
plains cree	crk	
pulabu	pup	
yecuatla totonac	tlc	
truká	tka	
kimbu	kiv	
ramopa	kjx	
aka-bo	akm	
arma	aoh	
colombian sign language	csn	
mono (usa)	mnr	
meroitic	xmr	
jamaican creole	jam	
new zealand sign language	nzs	
ghomara	gho	
kickapoo	kic	
bote-majhi	bmj	
laba	lau	
shinabo	snh	
panobo	pno	
veneto	vec	
samosa	swm	
swo	sox	
romanova	rmv	
tsuvan	tsh	
istro romanian	ruo	
kwangali	kwn	
gongduk	goe	
ubykh	uby	
borôro	bor	
bafut	bfd	
panytyima	pnw	
ninggerum	nxr	
holiya	hoy	
purik	prx	
ata manobo	atd	
gitxsan	git	
baga kaloum	bqf	
bayali	bjy	
emplawas	emw	
naga	jmn	kfw	kix	lpn	lzn	nbc	nbe	nbi	nbu	nct	njb	njh	njm	njn	njo	nkb	nkf	nkh	nki	nlq	nma	nme	nmf	nmh	nmo	nng	nnl	nnp	npg	nph	npo	npu	nqq	nqy	nre	nri	nsa	nsm	nst	ntx	nxk	nzm	pmx	pzn	tro	tvt	umn	yim	
ukwa	ukq	
nahavaq	sns	
tlamacazapa nahuatl	nuz	
san pedro quiatoni zapotec	zpf	
abron	abr	
meramera	mxm	
patep	ptp	
mgbolizhia	gmz	
mander	mqr	
pwo western karen	pwo	
bau bidayuh	sne	
yaouré	yre	
k'iche'	quc	
chiquián ancash quechua	qxa	
omani arabic	acx	
balinese malay	mhp	
iu mien	ium	
poule	msl	
tanapag	tpv	
bukwen	buz	
yanda dom dogon	dym	
bali (democratic republic of congo)	bcp	
yakut	sah	
daju	daj	dau	djc	
osage	osa	
maguindanaon	mdh	
bambalang	bmo	
tawandê	xtw	
ruma	ruz	
tira	tic	
konkani	gom	
muskum	mje	
rungwa	rnw	
pwaamei	pme	
kinalakna	kco	
waling	wly	
sicel	scx	
wagdi	wbr	
khaling	klr	
southern sama	ssb	
kapingamarangi	kpg	
saxon	nds	osx	sxu	
akkadian	akk	
luiseno	lui	
phuie	pug	
northern sami	sme	
krenak	kqq	
piame	pin	
semaq beri	szc	
toku-no-shima	tkn	
guwinmal	xgm	
cupeño	cup	
fam	fam	
tlazoyaltepec mixtec	mqh	
budu	buu	
jad	jda	
saposa	sps	
costa rican sign language	csr	
wallisian	wls	
hula	hul	
nunggubuyu	nuy	
láá láá bwamu	bwj	
kuuk-yak	uky	
ashe	ahs	
klingon	tlh	
meta'	mgo	
humla	hut	
balangao	blw	
mocho	mhc	
kpessi	kef	
mamboru	mvd	
northern pastaza quichua	qvz	
central cagayan agta	agt	
yerukula	yeu	
minangkabau	min	
padoe	pdo	
kandas	kqw	
kisa	lks	
sakachep	sch	
minanibai	mcv	
hiligaynon	hil	
malecite-passamaquoddy	pqm	
rawo	rwa	
anasi	bpo	
nyala	nle	
ngurimi	ngq	
nggwahyi	ngx	
chinsenga	nse	
judeo-arabic	jrb	
gulf arabic	afb	
southern one	osu	
inupiaq	ipk	
foau	flh	
sanskrit	san	
ulukwumi	ulb	
eastern highland chatino	cly	
krumen	ktj	pye	ted	
demisa	dei	
bagupi	bpi	
kendem	kvm	
konongo	kcz	
tachawit	shy	
gbe	ayb	cib	gbh	gbs	gbx	kqk	mxl	sxw	tfi	wci	wem	xwe	xwl	ewe	
not applicable	zxx	
ambulas	abt	
tengger	tes	
samberigi	ssx	
northern betsimisaraka malagasy	bmm	
sauri	srt	
classical quechua	qwc	
minkin	xxm	
margu	mhg	
wauyai	wuy	
oruma	orr	
luganda	lug	
unggaranggu	xun	
budukh	bdk	
southwest gbaya	gso	
nimo	niw	
tooro	ttj	
tangko	tkx	
bolon	bof	
javindo	jvd	
chrau	crw	
international sign	ils	
mori bawah	xmz	
hano	lml	
church slavic	chu	
tarjumo	txj	
dyula	dyu	
traveller danish	rmd	
northern muji	ymx	
guanano	gvc	
western juxtlahuaca mixtec	jmx	
hadiyya	hdy	
bekwel	bkw	
thai	nod	sou	tha	tts	
lengola	lej	
wiyot	wiy	
ehueun	ehu	
bomitaba	zmx	
mantsi	nty	
angika	anp	
mpotovoro	mvt	
kela (democratic republic of congo)	kel	
lamba	lam	
tso	ldp	
anglo-norman	xno	
taiwan sign language	tss	
kutto	kpa	
goaria	gig	
bantawa	bap	
zauzou	zal	
mala malasar	ima	
bacanese malay	btj	
eton (vanuatu)	etn	
twendi	twn	
subanon	skn	suc	
malawi sena	swk	
yasa	yko	
tamil	oty	tam	
oroko	bdu	
karo (ethiopia)	kxh	
ahirani	ahr	
surjapuri	sjp	
modern greek	ell	
alege	alf	
chabu	sbf	
ignaciano	ign	
central tarahumara	tar	
quapaw	qua	
dawera-daweloor	ddw	
mid grand valley dani	dnt	
ujir	udj	
zimakani	zik	
yale	kkl	nce	
wano	wno	
machiguenga	mcb	
pumi	pmi	pmj	
talu	yta	
gurindji kriol	gjr	gue	
lithuanian	lit	olt	
resígaro	rgr	
gagadu	gbu	
vaghri	vgr	
southern puget sound salish	slh	
mamaa	mhf	
nambas	nmb	
lika	lik	
dhuwal	dwu	
unua	onu	
northern dagara	dgi	
dibiyaso	dby	
lundayeh	lnd	
port vato	ptv	
northern ohlone	cst	
hanga	hag	
kpala	kpl	
hupa	hup	
wan	wan	
standard french	fra	
kete	kcv	
ayautla mazatec	vmy	
eastern yiddish	ydd	
wailaki	wlk	
italian	ita	
aushiri	avs	
yamna	ymn	
rasawa	rac	
blin	byn	
tadyawan	tdy	
bullom so	buy	
old bulgarian	chu	
bench	bcq	
mahongwe	mhb	
ixtenco otomi	otz	
dong	doc	doh	kmc	
kabyle	kab	
mursi	muz	
anus	auq	
gbii	ggb	
yawanawa	ywn	
muda	ymd	
sekele	vaj	
urumi	uru	
umotína	umo	
mbula	mna	
koki naga	nxk	
mfinu	zmf	
mehek	nux	
bomboma	bws	
ibibio	ibb	
bughotu	bgt	
amdo tibetan	adx	
cuvok	cuv	
aka-cari	aci	
coastal konjo	kjc	
barro negro tunebo	tbn	
dení	dny	
provençal	pro	
northern huishui miao	hmi	
kru'ng 2	krr	
temoaya otomi	ott	
yaul	yla	
ghandruk sign language	gds	
ukue	uku	
tampias lobu	low	
chang naga	nbc	
aquitanian	xaq	
dusun deyah	dun	
haiphong sign language	haf	
shark bay	ssv	
turi	trd	
kanembu	kbl	
mungaka	mhk	
malaysian sign language	xml	
poyanáwa	pyn	
avestan	ave	
bali	ban	
hadothi	hoj	
yameo	yme	
wampar	lbq	
cajonos zapotec	zad	
oune	oue	
ma'di	mhi	snm	
kapin	tbx	
pintupi-luritja	piu	
north central mixe	neq	
northern mashan hmong	hmp	
luba-katanga	lub	
tarok	yer	
mal	mlf	
sobei	sob	
malyangapa	yga	
pano	mqz	xpk	
uspanteco	usp	
mono (solomon islands)	mte	
semimi	etz	
southern tidung	itd	
umbundu	umb	
dungan	dng	
classical nepal bhasa	nwc	
tachelhit	shi	
kilmeri	kih	
chickasaw	cic	
lanoh	lnh	
moroccan arabic	ary	
bangwinji	bsj	
mpade	mpi	
hmong njua	hnj	
bouyei	pcc	
roria	rga	
kaidipang	kzp	
tennet	tex	
dhargari	dhr	
kwényi	kdk	
northern oaxaca nahuatl	nhy	
berau malay	bve	
chokwe	cjk	
iraya	iry	
mongondow	mog	
gen	gej	
amahai	amq	
kabras	lkb	
saurashtra	saz	
foma	fom	
old korean (3rd-9th cent.)	oko	
gāndhārī	pgd	
bung	bqd	
kaiku	kkq	
laz	lzz	
alapmunte	apv	
ganda	lug	
southern sami	sma	
flemish sign language	vgt	
seze	sze	
jju	kaj	
murle	mur	
chakali	cli	
central mazahua	maz	
sauraseni prākrit	psu	
sasak	sas	
usan	wnu	
coyotepec popoloca	pbf	
batak angkola	akb	
mbati	mdn	
iloko	ilo	
romano-serbian	rsb	
assiniboine	asb	
bahau	bhv	
tepeuxila cuicatec	cux	
kuanyama	kua	
narom	nrm	
dagaare	dga	
tuamotuan	pmt	
ngombale	nla	
tofin gbe	tfi	
yangum gel	ygl	
lelemi	lef	
siwai	siw	
maiwa (indonesia)	wmm	
wudu	wud	
torá	trz	
talodi	tlo	
watam	wax	
czech	ces	
oriya (individual language)	ory	
izora	cbo	
keres	kee	kjq	
caquinte	cot	
central sierra miwok	csm	
nasal	nsy	
aguano	aga	
ipiko	ipo	
namat	nkm	
nataoran amis	ais	
pu ko	puk	
goreng	xgg	
wadaginam	wdg	
gaa	ttb	
aimol	aim	
shuwa-zamani	ksa	
mansaka	msk	
datooga	tcc	
jinuo	jiu	jiy	
lame	bma	
chiangmai sign language	csd	
standard moroccan tamazight	zgh	
e'ma buyang	yzg	
mednyj aleut	mud	
uduk	udu	
koyraboro senni songhai	ses	
paasaal	sig	
barok	bjk	
martuthunira	vma	
matagalpa	mtn	
matengo	mgv	
vata (dic) + gbadi	btg	
tidung	itd	ntd	
attapady kurumba	pkr	
burarra	bvr	
tama (colombia)	ten	
leonese	ast	
kele (papua new guinea)	sbc	
old slavonic	chu	
yagaria	ygr	
fars	fay	faz	
solano	xso	
akukem	spm	
katso	kaf	
plains indian sign language	psd	
tereweng	twg	
dogul dom dogon	dbg	
kullu pahari	kfx	
bankal	jjr	
kami (tanzania)	kcu	
ghayavi	bmk	
ambonese malay	abs	
bondei	bou	
swampy cree	csw	
peñoles mixtec	mil	
yakan	yka	
yanomamö	guu	
songo	soo	
malinaltepec me'phaa	tcf	
palaic	plq	
kimbundu	kmb	
kemiehua	kfj	
dongotono	ddd	
kemi sami	sjk	
ik	ikx	
amba (solomon islands)	utp	
ratagnon	btn	
yardliyawarra	yxl	
bonerif	bnv	
wyandot	wya	
marenje	vmr	
iyive	uiv	
wanambre	wnb	
dulong	duu	
old newari	nwc	
northern tepehuan	ntp	
yeyi	yey	
shuswap	shs	
agariya	agi	
fore	for	
fiji hindi	hif	
rukai	dru	
querétaro otomi	otq	
malas	mkr	
muong	mtq	
emerillon	eme	
paumarí	pad	
ugong	ugo	
satawalese	stw	
galambu	glo	
kraol	rka	
nokuku	nkk	
san pedro amuzgos amuzgo	azg	
okinawan	ryu	
labir	jku	
saho	ssy	
sarangani manobo	mbs	
ngam	nmc	
yanesha'	ame	
konkani (individual language)	knn	
armenian sign language	aen	
mina (india)	myi	
batak karo	btx	
ǂungkue	gku	
old manipuri	omp	
etebi	etb	
gogo	gog	
bobot	bty	
tause	tad	
shoo-minda-nye	bcv	
aikanã	tba	
zuni	zun	
balantak	blz	
shahrudi	shm	
deno	dbb	
huaylas ancash quechua	qwh	
akar-bale	acl	
rendille	rel	
huamalíes-dos de mayo huánuco quechua	qvh	
faiwol	fai	
baima	bqh	
beli (papua new guinea)	bey	
burushaski	bsk	
waropen	wrp	
thai song	soa	
basa (cameroon)	bas	
dom	doa	
hamer-banna	amf	
san miguel piedras mixtec	xtp	
bukitan	bkn	
yemba	ybb	
maru	mhx	
middle english	enm	
sake	sak	
taman (myanmar)	tcl	
kamasau	kms	
galatian	xga	
shelta	sth	
shamang	xsh	
kumbaran	wkb	
eblan	xeb	
sumbawa	smw	
yapese	yap	
pedi	nso	
mayaguduna	xmy	
hawai'i pidgin sign language	hps	
taulil	tuh	
border kuna	kvn	
bamwe	bmg	
namakura	nmk	
ganglau	ggl	
degenan	dge	
senhaja de srair	sjs	
pitcairn-norfolk	pih	
sarikoli	srh	
huilliche	huh	
lambya	lai	
s'gaw karen	ksw	
faire atta	azt	
kasiguranin	ksn	
rerau	rea	
kembra	xkw	
urarina	ura	
ashéninka	cpb	cpu	cpy	
rana tharu	thr	
hlai	lic	
kwakum	kwu	
skolt sami	sms	
san agustín mixtepec zapotec	ztm	
eastern apurímac quechua	qve	
kuni	kse	
kawaiisu	xaw	
luo (cameroon)	luw	
madak	mmx	
bara malagasy	bhr	
hidatsa	hid	
kamaru	kgx	
kwasio	nmg	
yareba	yrb	
amele	aey	
hong kong sign language	hks	
puinave	pui	
arop-lokep	apr	
kwara'ae	kwf	
zotung chin	czt	
abui	abz	
chinali	cih	
bima	bhp	
moldavian	ron	
luguru	ruf	
nawdm	nmz	
pasi	psq	
nanubae	afk	
kalabra	kzz	
mogholi	mhj	
vono	kch	
sierra leone sign language	sgx	
classical mandaic	myz	
smärky kanum	kxq	
mfumte	nfu	
waube	kop	
shasta	sht	
oirat	xal	xwo	
gude	gde	
gaddang	gad	
toram	trj	
great andamanese	gac	
kannada kurumba	kfi	
vedic	san	
tausug	tsg	
northeast pashayi	aee	
magahi	mag	
mirgan	zrg	
karakhanid	xqa	
jennu kurumba	xuj	
tewe	twx	
lepontic	xlp	
djangu	dhg	
solong	aaw	
tlapanec	tcf	tpc	tpl	tpx	
kupang malay	mkn	
santa inés yatzechi zapotec	zpn	
tene kan dogon	dtk	
igede	ige	
koya	kff	
ofo	ofo	
meoswar	mvx	
kunbarlang	wlg	
northern ngbandi	ngb	
tokelau	tkl	
baissa fali	fah	
east nyala	nle	
lasi	lss	
western yiddish	yih	
pacaraos quechua	qvp	
awera	awr	
aché	guq	
glaro-twabo	glr	
northern bobo madaré	bbo	
itawit	itv	
huaulu	hud	
south muyu	kts	
rangkas	rgk	
shama-sambuga	sqa	
katkari	kfu	
cotabato manobo	mta	
miani	pla	
monpa	kkf	twm	
hawai'i sign language (hsl)	hps	
tairuma	uar	
wè northern	wob	
northern subanen	stb	
central mam	mvc	
burdekin	xbb	
kur	kuv	
biri	bzr	
kw'adza	wka	
karnic	ekc	
chiquitano	cax	
sonaga	ysg	
tankarana malagasy	xmv	
marrucinian	umc	
kaan	ldl	
kabwa	cwa	
long wat	ttw	
bube	bvb	
north ndebele	nde	
kavalan	ckv	
urum	uum	
rāziḥī	rzh	
ikaranggal	ikr	
lengua de señas panameñas	lsp	
mo'da	gbn	
ila	ilb	
alago	ala	
classical portuguese	mis	
ucayali-yurúa ashéninka	cpb	
övdalian	ovd	
chamalal	cji	
nusu	nuf	
lere	gnh	
koguryo	zkg	
tujia	tji	tjs	
southern kurdish	sdh	
maya	yua	itz	
sukuma	suk	
guató	gta	
teor	tev	
chala	cll	
baram kayan	kys	
wu chinese	wuu	
abkhazian	abk	
galician	glg	
chaima	ciy	
chicahuaxtla triqui	trs	
tee	tkq	
asaro'o	mtv	
kpatili	kym	
subanen	laa	sfe	stb	syb	
muthuvan	muv	
togoyo	tgy	
lugbara	lgg	
otuho	lot
lotuho	lot
kazakh	kaz	
akebu	keu	
mbunga	mgy	
kwinsu	kuc	
koiari	kbk	
andoque	ano	
liabuku	lix	
kohistani shina	plk	
dimasa	dis	
far western muria	fmu	
polabian	pox	
betta kurumba	xub	
itelmen	itl	
aramaic	arc	jpa	oar	sam	tmr	
meriam	ulk	
arop-sissano	aps	
urimo	urx	
french	fra	frc	frm	fro	
panyi bai	bfc	
skalvian	svx	
koro (vanuatu)	krf	
kita maninkakan	mwk	
hutterite german	geh	
marka	rkm	
hijuk	hij	
lahu shi	lhi	
mogum	mou	
marangis	wax	
makhuwa-saka	xsq	
kumalu	ksl	
dangaura tharu	thl	
leyigha	ayi	
cacaloxtepec mixtec	miu	
nauru	nau	
paniya	pcg	
kurdish	ckb	kmr	kur	sdh	
ukrainian sign language	ukl	
larantuka malay	lrt	
texmelucan zapotec	zpz	
bade	bde	
negerhollands	dcr	
yintale	kvy	
northeast maidu	nmu	
xârâgurè	axx	
kamoro	kgq	
kalkutungu	ktg	
lingua franca	pml	
dhurga	dhu	
urali	url	
ikizu	ikz	
nduga	ndx	
lower tanana	taa	
ayerrerenge	axe	
takua	tkz	
holikachuk	hoi	
kepo'	kuk	
dusun witu	duw	
somba-siawari	bmu	
tiéfo	tiq	
saidi arabic	aec	
masaaba	myx	
bouna kulango	nku	
mang	zng	
owenia	wsr	
tebul sign language	tsy	
sou upaa	wha	
nde-gbite	ned	
bangka	mfb	
chothe naga	nct	
pa-hng	pha	
rathawi	rtw	
mandan	mhq	
kapampangan	pam	
yatay	yty	
paranan	prf	
jah hut	jah	
anindilyakwa	aoi	
hurrian	xhu	
slovak	slk	
nguluwan	nuw	
norra	nrr	
wara	wbf	
samarokena	tmj	
oirata	oia	
garhwali	gbm	
chiripá	nhd	
cocos islands malay	coa	
adara	kad	
vehes	val	
bulgebi	bmp	
inabaknon	abx	
venetic	xve	
jamaican sign language	jls	
ingrian	izh	
kawi	kaw	
seediq	trv	
oromo	gax	gaz	hae	orm	
mina (cameroon)	hna	
choni	cda	
ebughu	ebg	
sierra negra nahuatl	nsu	
inga	inb	inj	
bunu	buh	bwn	bwx	pnu	
shiki	gua	
firan	fir	
northern grebo	gbo	
xanaguía zapotec	ztg	
yitha yitha	xth	
na	nbt	
kaera	jka	
cahuilla	chl	
yazgulyam	yah	
dibo	dio	
kemedzung	dmo	
chayuco mixtec	mih	
eastern huishui hmong	hme	
manga kanuri	kby	
yarsun	yrs	
alagwa	wbj	
slavonic	chu	
cook islands maori	rar	
eastern tawbuid	bnj	
manduri	bmd	
nungali	nug	
musey	mse	
south west bay	sns	
nanti	cox	
tampuan	tpu	
epigraphic mayan	emy	
tai loi	tlq	
miahuatlán zapotec	zam	
àhàn	ahn	
piu	pix	
southern toussian	wib	
siculo arabic	sqr	
tagargrent	oua	
kerewe	ked	
suga	sgi	
kurtokha	xkz	
bukharic	bhh	
bardi	bcj	
longgu	lgu	
lokoya	lky	
lakalei	lka	
mak (nigeria)	pbl	
ngarinman	nbj	
musom	msu	
mandandanyi	zmk	
shwe palaung	pll	
puri	prr	
murik (malaysia)	mxr	
dhodia	dho	
gwa	gwb	
bhasa	new	
doko-uyanga	uya	
wadjigu	wdu	
old cornish	oco	
ngbaka ma'bo	nbm	
san lucas quiavini	zab	
orowe	bpk	
baimak	bmx	
lolo	llb	
kapori	khp	
cavineña	cav	
kwini	gww	
banggarla	bjb	
caló	rmq	
dagara	dgi	
powhatan	pim	
yoruba	yor	yea	
mochica	omc	
wambon	wms	
fanti	fat	
nshi	nsc	
chulym	clw	
mangala	mem	
lefa	lfa	
nooksack	nok	
alabat island agta	dul	
kpelle	gkp	kpe	xpe	
ulithian	uli	
pökoot	pko	
blaan	bpr	bps	
pangwali	pgg	
palu'e	ple	
ughele	uge	
ndumu	nmd	
abaza	abq	
grangali	nli	
wewaw	wea	
tabasco zoque	zoq	
munji	mnj	
kumzari	zum	
romani	rmc	rmf	rml	rmn	rmo	rmu	rmw	rmy	
tonsawang	tnw	
puare	pux	
pahanan agta	apf	
swedish sign language	swl	
bagirmi	bmi	
unami	unm	
kagate	syw	
herdé	hed	
moi (congo)	mow	
eastern nisu	nos	
taimyr pidgin russian	mis	
biafada	bif	
yele	yle	
pular	fuf	
madhi madhi	dmd	
suabo	szp	
wakde	wkd	
sangu (gabon)	snq	
akolet	akt	
kadar	kej	
malgana	vml	
bemba (zambia)	bem	
eastern abnaki	aaq	
judeo-tat	jdt	
wanda	wbh	
monastic sign language	mzg	
thracian	txh	
bagri	bgq	
gimi (west new britain)	gip	
lhomi	lhm	
ubi	ubi	
lakhota	lkt	
n'ko	nqo	
aequian	xae	
kesawai	xes	
belarusian	bel	
manggarai	mqy	
choctaw	cho	
dicamay agta	duy	
ngamini	nmv	
jwira-pepesa	jwi	
nyiha (malawi)	nyr	
siberian tatar	sty	
eastern penan	pez	
karadjeri	gbd	
phuma	ypm	
central hongshuihe zhuang	zch	
bete-bendi	btt	
horo	hor	
kwa'	bko	
nepalese sign language	nsp	
sinyar	sys	
kuthant	xut	
aja (benin)	ajg	
delo	ntr	
galeya	gar	
tangkhul naga (myanmar)	ntx	
silacayoapan mixtec	mks	
danaru	dnr	
yidin	yii	
sîshëë	sih	
galindan	xgl	
lamma	lev	
eki	eki	
jaqaru	jqr	
buglere	sab	
angguruk yali	yli	
ancient greek	grc	
guyani	gvy	
suau	swp	
pááfang	pfa	
old turkish	otk	
quiegolani zapotec	zpi	
maore comorian	swb	
kwa	kwb	
sanumá	xsu	
amaimon	ali	
roviana	rug	
loup b	xlb	
jemez	tow	
watubela	wah	
todrah	tdr	
bacama	bcy	
kaapor	urb	
korafe-yegha	kpr	
gallurese sardinian	sdn	
gengle	geg	
swahili	swc	swh	
dhundari	dhd	
jandavra	jnd	
malasar	ima	ymr	
itu mbon uzo	itm	
gurmana	gvm	
vanimo	vam	
gumawana	gvs	
asheninka	cni	
koti	eko	
sidamo	sid	
jaru	ddj
Djaru	ddj
tayart tamajeq	thz	
northern dong	doc	
ma'anyan	mhy	
thudam	thw	
koiwat	kxt	
ipulo	ass	
miyobe	soy	
southeastern ixtlán zapotec	zpd	
amahuaca	amc	
biao	byk	
tigon mbembe	nza	
gahri	bfu	
halkomelem	hur	
kairui-midiki	krd	
ruuli	ruc	
ombamba	mbm	
wanga	lwg	
pangwa	pbr	
aromanian	rup	
zande (individual language)	zne	
sausi	ssj	
araona	aro	
eteocypriot	ecy	
bungku	bkz	
rincón zapotec	zar	
siuslaw	sis	
scottish	trl	
kven finnish	fkv	
guro	goa	
kensiu	kns	
uzbek	uzb	uzn	uzs	
makuráp	mpu	
bainouk-gunyuño	bab	
moji	ymi	
li'o	ljl	
nisga'a	ncg	
south marquesan	mqm	
woccon	xwc	
makalero	mjb	
konai	kxw	
takestani	tks	
haméa	cir	
aka	soh	
kyaka	kyc	
elkei	elk	
monom	moo	
nend	anh	
san felipe otlaltepec popoloca	pow	
dawawa	dww	
karnai	bbv	
mzieme naga	nme	
koromfé	kfz	
mosimo	mqv	
ménik	tnr	
arapaso	arj	
judeo-italian	itk	
pahlavi	pal	
honi	how	
muyu	kti	kts	
ancient north arabian	xna	
mbonga	xmb	
akan	aka	
samba daka	ccg	
western bukidnon manobo	mbb	
kwalhioqua-tlatskanai	qwt	
wayampi	oym	
folopa	ppo	
lopit	lpx	
nzakambay	nzy	
vai	vai	
chesu	ych	
guajajára	gub	
fe'fe'	fmp	
kauwera	xau	
huaxcaleca nahuatl	nhq	
zumaya	zuy	
baloi	biz	
axi yi	yix	
marwari (india)	rwr	
kambaira	kyy	
hwana	hwo	
torres strait creole	tcs	
bendi	bct	
kugbo	kes	
gwandara	gwn	
kwegu	xwg	
lithuanian sign language	lls	
guibian zhuang	zgn	
settla	sta	
djimini senoufo	dyi	
paraujano	pbg	
kodi	kod	
kok-nar	gko	
nugunu (australia)	nnv	
dakpakha	dka	
landoma	ldm	
syriac	syc	syr	
yerakai	yra	
cung	cug	
paku	pku	
guevea de humboldt zapotec	zpg	
garo	grt	
arikapú	ark	
warji	wji	
lang'e	yne	
kaingang	kgp	
teke-ebo	ebo	
bété	bev	btg	
romblomanon	rol	
whitesands	tnp	
asu (tanzania)	asa	
barang-barang	lji	
ter sami	sjt	
rade	rad	
bilur	bxf
kayardild	gyd	
chadian arabic	shu	
khlor	llo	
west albay bikol	fbl	
wanka qechua	qvw	
tama (chad)	tma	
gaikundi	gbf	
kairak	ckr	
wamin	wmi	
polari	pld	
kamano	kbq	
ajië	aji	
olkol	olk	
afrihili	afh	
lampung nyo	abl	
halang doan	hld	
western huasteca nahuatl	nhw	
kalao	kly	
lobala	loq	
nottoway-meherrin	nwy	
pangutaran sama	slm	
bokoto	bdt	
mudburra	dmw
mudbarra	mwd
southern ma'di	snm	
kurmukar	kfv	
oyda	oyd	
lakkia	lbc	
dar daju daju	djc	
teochew	nan	
sehwi	sfw	
namia	nnm	
mitla zapotec	zaw	
chamicuro	ccc	
yessan-mayo	yss	
san francisco matlatzinca	mat	
kayort	kyv	
paicî	pri	
maia	sks	
sora	srb	
straits salish	str	
coatlán mixe	mco	
chorote	crq	crt	
badaga	bfq	
southern rincon zapotec	zsr	
carpathian romani	rmc	
kimaragang	kqr	
colonia tovar german	gct	
georgisch	kat	
tombulu	tom	
lwalu	lwa	
tahaggart tamahaq	thv	
fas	fqs	
ormu	orz	
french belgian sign language	sfb	
mwerlap	mrm	
pa'o karen	blk	
balo	bqo	
manipuri	mni	omp	
hruso	hru	
babatana	baa	
bisu	bzi	
aka-kede	akx	
auwe	smf	
paiwan	pwn	
lohar	gda	lhl	
korowai	khe	
andaandi	dgl	
tarangan	tre	txn	
berinomo	bit	
kpati	koc	
ebira	igb	
mayoyao ifugao	ifu	
kashmiri	kas	
northern qiandong miao	hea	
hattic	xht	
mien	bje	ium	
yan-nhaŋu sign language	yhs	
mexican sign language	mfs	
raute	rau	
dobel	kvo	
kirmanjki (macrolanguage)	zza	
sedang	sed	
osatu	ost	
//xegwi	xeg	
eloyi	afo	
tabasco chontal	chf	
andarum	aod	
pamona	pmf	
mycenaean greek	gmy	
lubuagan kalinga	knb	
pfaelzisch	pfl	
dekwana	mch	
highland oaxaca chontal	chd	
marriammu	xru	
lou	loj	
deg	mzw	
hausa	hau	
taje	pee	
papua new guinean sign language	pgz	
sapo	krn	
blissymbolics	zbl	
qiang	cng	qxs	
yoloxochitl mixtec	xty	
trinidadian creole english	trf	
northwest pashayi	glh	
sira	swj	
kiong	kkm	
cumbric	xcb	
middle hittite	htx	
ribun	rir	
sãotomense	cri	
kubo	jko	
central khmer	khm	
cutchi-swahili	ccl	
west central banda	bbp	
central malay	pse	
sie	erg	
keley-i kallahan	ify	
ende	end	
tay boi	tas	
samre	sxm	
legenyem	lcc	
kinga	zga	
bahamas creole english	bah	
southern tiwa	tix	
sanga (nigeria)	xsn	
fiwaga	fiw	
banda-banda	bpd	
tregami	trm	
nambikuára	nab	
anuak	anu	
persian sign language	psc	
kölsch	ksh	
maxakalí	mbl	
limba	lia	lma	
anyin morofo	mtb	
tomadino	tdi	
da'a kaili	kzf	
polish sign language	pso	
jenaama bozo	bze	
cinda-regi-tiyal	cdr	
kukna	kex	
lala-bisa	leb	
bilua	blb	
coatzospan mixtec	miz	
central melanau	mel	
tomo kan dogon	dtm	
chippewa	ciw	
q'anjob'al	kjb	
bakole	kme	
cashibo-cacataibo	cbr	
sarudu	sdu	
ibatan	ivb	
spanish	osp	spa	spq	
haroi	hro	
adioukrou	adj	
war-jaintia	aml	
pecheneg	xpc	
dhao	nfa	
mabire	muj	
mapos buang	bzh	
munsee	umu	
garlali	gll	
mofu-gudur	mif	
tanglang	ytl	
iwam	iwm	iws	
sanapaná	spn	
pinji	pic	
krio	kri	
tutong	ttg	
ao naga	njo	
western canadian inuktitut	ikt	
kabalai	kvf	
karelian	krl	
enrekang	ptt	
barbaram	vmb	
afra	ulf	
wotjobaluk	xwt	
korupun-sela	kpq	
manza	mzv	
borana-arsi-guji oromo	gax	
kelabit	kzi	
capanawa	kaq	
sonde	shc	
nyengo	nye	
nsongo	nsx	
gimi (eastern highlands)	gim	
dumbea	duf	
anguthimri	awg	
kanite	kmu	
nek	nif	
zenag	zeg	
woria	wor	
yinwum	yxm	
kunja	pep	
aja (sudan)	aja	
alawa	alh	
boano (maluku)	bzn	
alo phola	ypo	
tu	mjg	
gaddi	gbk	
parecís	pab	
meskwaki	sac	
hmong dô	hmv	
dutch	dum	nld	odt
modern dutch	nld
haya	hay	
kubu	kvb	
pahari	bfz	kfx	
jarai	jra	
south lembata	lmf	
mapidian	mpw	
paakantyi	drl	
maba (indonesia)	mqa	
akrukay	afi	
central aymara	ayr	
old dutch	odt	
bribri	bzd	
ghanaian sign language	gse	
zayein karen	kxk	
sesotho	sot	
ngoni	ngo	nse	
seit-kaitetu	hik	
terei	buo	
busami	bsm	
gimnime	gmn	
quiripi	qyp	
khalaj	kjf	klj	
capanahua	kaq	
yambeta	yat	
brunei bisaya	bsb	
skepi creole dutch	skw	
yarawata	yrw	
digaro-mishmi	mhu	
furu	fuu	
andajin	ajn	
onin based pidgin	onx	
panasuan	psn	
tubar	tbu	
numidian	nxm	
sudanese creole arabic	pga	
pawnee	paw	
nung (viet nam)	nut	
qawasqar	alc	
yuwana	yau	
lo-toga	lht	
nias	nia	
sabaean	xsa	
kumyk	kum	
dwang	nnu	
naluo yi	ylo	
sumi naga	nsm	
tuxináwa	tux	
mafa	maf	
piapoco	pio	
ardhamāgadhī prākrit	pka	
ga	gaa	
totomachapan zapotec	zph	
kara (korea)	zra	
upper kinabatangan	dmg	
turung	try	
lower chehalis	cea	
quichua	qud	qug	qus	quw	qvi	qvj	qvz	qxl	qxr	
atong (india)	aot	
dezfuli	def	
dogoso	dgs	
pitjantjatjara	pjt	
juwal	mwb	
baga pokur	bcg	
ngantangarra	ntg	
dominican sign language	doq	
valencian	cat	
jibu	jib	
saleman	sau	
pam	pmn	
tlachichilco tepehua	tpt	
koi	kkt	
bonggo	bpg	
kakanda	kka	
lehalurup	urr	
jurúna	jur	
mittu	mwu	
ocaina	oca	
akei	tsr	
ap ma	kbx	
humene	huf	
chin	anl	bgr	cbl	cek	cfm	ckn	clj	clt	cmr	cnb	cnh	cnk	cnw	csh	csj	csv	csy	ctd	cth	czt	dao	hlt	mrh	mwq	pck	rtc	sez	tcp	tcz	weu	zyp	
iranun (philippines)	ilp	
karang	kzr	
pentlatch	ptw	
jangkang	djo	
od	odk	
lianshan zhuang	zln	
fagauvea	uve	
gawar-bati	gwt	
agusan manobo	msm	
yahang	rhp	
ashéninka perené	prq	
jiiddu	jii	
kobiana	kcj	
northwestern nisu	nsf	
jalapa de díaz mazatec	maj	
abureni	mgj	
spiti bhoti	spt	
sinasina	sst	
sian	spg	
tamanaku	tmz	
mohave	mov	
pokomo	pkb	
dineor	mrx	
kangiryuarmiut	ikt	
kunza	kuz	
mawchi	mke	
tohono o'odham	ood	
acoli	ach	
chhulung	cur	
moldovan	ron	
natanzi	ntz	
kara (tanzania)	reg	
wumbvu	wum	
bedoanas	bed	
southern conchucos ancash quechua	qxo	
dimbong	dii	
pagu	pgu	
ambo-pasco quechua	qva	
bagvalal	kva	
remontado dumagat	agv	
berom	bom	
marba	mpg	
southeastern pomo	pom	
merey	meq	
chimariko	cid	
jambi malay	jax	
nyali	nlj	
northern nago	xkb	
makonde	kde	
kallahan	ify	kak	
uripiv-wala-rano-atchin	upv	
jirel	jul	
nootka	noo	
tambora	xxt	
romanian sign language	rms	
tembé	tqb	
foi	foi	
kalumpang	kli	
santo domingo albarradas zapotec	zas	
kumhali	kra	
old georgian	oge	
likum	lib	
tambotalo	tls	
yamphu	lrr	ybi	
turkish	bgx	crh	ota	otk	tur	
ilwana	mlk	
stieng	sti	stt	
jandai	jan	
western lalu	ywl	
west uvean	uve	
kashaya	kju	
northern huishui hmong	hmi	
bantayanon	bfx	
gowli	gok	
yinchia	yin	
sonha	soi	
gaulish	xcg	xtg	
pileni	piv	
nalca	nlc	
maisin	mbq	
siwi	siz	
nedebang	nec	
asháninka	cni	
bosngun	bqs	
wik-iiyanh	wij	
iranian 	pes
nocte naga	njb
nocte	njb
dewoin	dee	
mur pano	tkv	
ngadjuri	jui	
agwagwune	yay	
creole arabic	bbz	pga	
kaba	ksp	
limassa	bme	
yaweyuha	yby	
han	haa	
tring	tgq	
aduge	adu	
classical syriac	syc	
buksa	tkb	
eten	etx	
kuni-boazi	kvg	
ciwogai	tgd	
keyagana	kyg	
east kewa	kjs	
kowaki	xow	
narak	nac	
micmac	mic	
likila	lie	
kalaamaya	lkm	
tlacoatzintepec chinantec	ctl	
ata	atm	
old welsh	owl	
morokodo	mgc	
isthmus-pajapan nahuatl	nhp	
dâw	kwa	
dogrib	dgr	
marau	mvr	
vaagri booli	vaa	
tunisian sign language	tse	
singapore malay	mly	
ixcatlán mazatec	mzi	
nepali (individual language)	npi	
olunyole	nyd	
marama	lrm	
kota marudu talantang	grm	
zarma	dje	
andaqui	ana	
thachanadan	thn	
ojibwe	otw	ojg	
bali (nigeria)	bcn	
tangut	txg	
hausa sign language	hsl	
kofyar	kwl	
manusela	wha	
hunde	hke	
wakhi	wbl	
cajamarca quechua	qvc	
palula	phl	
dandami maria	daq	
karon dori	kgw	
miwok	csi	csm	lmw	mkq	nsq	pmw	skd	
mituku	zmq	
pakaásnovos	pav	
arifama-miniafia	aai	
ifugao	ifa	ifb	ifk	ifu	
hamba	hba	
láadan	ldn	
white lachi	lwh	
mangareva	mrv	
erre	err	
olusamia	lsm	
matya samo	stj	
biao mon	bmt	
kol (bangladesh)	ekl	
el molo	elo	
lapaguía-guivini zapotec	ztl	
byep	mkk	
koireng	nkd
barambu	brm	
brahui	brh	
nguôn	nuo	
xishanba lalo	ywt	
bana	bcw	
tuwuli	bov	
karao	kyj	
teke-nzikou	nzu	
persian	fas	peo	pes	prs	xmn	
batad ifugao	ifb	
mambwe-lungu	mgr	
ngalakan	nig	
sabanê	sae	
binandere	bhg	
kovai	kqb	
guarequena	gae	
xwela gbe	xwe	
yami	tao	
kosarek yale	kkl	
nyulnyul	nyv	
north ambrym	mmg	
kunyi	njx	
nimi	nis	
rengao	ren	
hazaragi	haz	
waamwang	wmn	
male (papua new guinea)	mdc	
ahwai	nfd	
toaripi	tqo	
suruí	sru	
tharaka	thk	
isabi	isa	
biwat	bwm	
massalat	mdg	
ixil	ixl	
tugutil	tuj	
vagla	vag	
lak	lbe	
duau	dva	
lengo	lgr	
nehan	nsn	
awa (papua new guinea)	awb	
inebu one	oin	
krahn	kqo	krw	
kinabalian	cbw	
faroese	fao	
nepali kurux	kxl	
korur	auq	
mintil	mzt	
rapting	rpt	
shekkacho	moy	
saya	say	
eviya	gev	
istriot	ist	
baruga	bjz	
kap	ykm	
koko babangk	okg	
ditidaht	dtd	
volapük	vol	
makayam	aup	
ansus	and	
wichí lhamtés güisnay	mzh	
hpon	hpo	
western highland chatino	ctp	
komyandaret	kzv	
chru	cje	
gbaya-bossangoa	gbp	
kipsigis	sgc	
lillooet	lil	
kalasha	kls	
são paulo kaingáng	zkp	
birked	brk	
wawonii	wow	
rawa	rwo	
gweda	grw	
lewo	lww	
fataluku	ddg	
korra koraga	kfd	
ohlone	css	cst	
turks and caicos creole english	tch	
lua'	prb	
ngandyera	nne	
bambili-bambui	baw	
bankan tey dogon	dbw	
siona	snn	
vlaams	vls	
mae	mme	
kunjen	kjn	
narau	nxu	
bezhta	kap	
varli	vav	
francoprovençal	frp	
horom	hoe	
tenharim	pah	
edwas	bnv	
yil	yll	
pirahã	myp	
ngazidja comorian	zdj	
northern thai	nod	
chaura	crv	
asue awyu	psa	
namla	naa	
spanish (spa) + english	eng	
finongan	fag	
sininkere	skq	
malua bay	mll	
tokharian b	txb	
gamit	gbl	
jewish babylonian aramaic (ca. 200-1200 ce)	tmr	
watakataui	wtk	
dugwor	dme	
kua-nsi	ykn	
dijim-bwilim	cfa	
nyore	nyd	
zambian sign language	zsl	
nyindu	nyg	
dambi	dac	
kakabe	kke	
gazi	gzi	
mro-khimi chin	cmr	
aruop	lsr	
nkari	nkz	
standard arabic	arb	
batak	bya	
woun meu	noa	
krisa	ksi	
ligurian (ancient)	xlg	
ija-zuba	vki	
salinan	sln	
chácobo	cao	
herero	her	
lamaholot	slp	
tonsea	txs	
italian sign language	ise	
lower silesian	sli	
judeo-tripolitanian arabic	yud	
onin	oni	
pero	pip	
tharu	the	thl	thq	thr	tkt	
wares	wai	
taita	dav	
col	liw	
kabuverdianu	kea	
bati (indonesia)	bvt	
east limba	lma	
kholok	ktc	
panamanian sign language	lsp	
papasena	pas	
western abnaki	abe	
yindjibarndi	yij	
tiwi	tiw	
mboko	mdu	
chavacano	cbk	
kucong	lkc	
ndengereko	ndg	
mag-indi ayta	blx	
liangmai naga	njn	
mbo (democratic republic of congo)	zmw
phom naga	nph	
kaikavian literary language	kjv	
marovo	mvo	
mong njua	hnj	
nyamwanga	mwn	
banda	bbp	bjo	lnl	tor	
urubú-kaapor	urb	
pomo	peb	pef	pej	peq	pmm	pom	poo	
yuyu	yxu	
north slavey	scs	
samba leko	ndi	
amundava	adw	
mbembe	mfn	nza	
drents	drt	
western tawbuid	twb	
toto	txo	
northwest oaxaca mixtec	mxa	
hindi	hif	hin	
embaloh	emb	
machame	jmc	
saramaccan	srm	
papel	pbo	
lipo	lpo	
southern sorsoganon	srv	
middle high german	gmh	
bum	bmv	
komi	kom	
menominee	mez	
ngarla	nrk	
biak	bhw	
lishanid noshan	aij	
kadu	zkd	
goan konkani	gom	
tiagbamrin aizi	ahi	
arakwal	rkw	
eastern khumi chin	cek	
gaina	gcn	
flemish	nld	vls	
gowlan	goj	
guruntum-mbaaru	grd	
kutu	kdc	
pankararé	pax	
comox	coo	
lao	lao	
lü	khb	
bathari	bhm	
alabama	akz	
abua	abn	
vunjo	vun	
krim	krm	
southern sotho	sot	
akurio	ako	
kashubian	csb	
seberuang	sbx	
palantla chinantec	cpa	
gbaya (sudan)	krs	
nkangala	nkn	
côông	cnc	
kulere	kul	
siwu	akp	
mato	met	
lumun	lmd	
titan	ttv	
wejewa	wew	
gagauz	gag	
waxianghua	wxa	
bada (nigeria)	bau	
pyen	pyy	
yaben	ybm	
eastern subanen	sfe	
besme	bes	
chenapian	cjn	
vaeakau-taumako	piv	
amis	ais	ami	
nisenan	nsz	
tsez	ddo	
zia	zia	
ewage-notu	nou	
obokuitai	afz	
boruca	brn	
wom (papua new guinea)	wmo	
tomoip	tqp	
jere	jer	
wintu	wnw	
polci	plj	
abishira	ash	
central atlas tamazight	tzm	
malaynon	mlz	
passamaquoddy	pqm	
adai	xad	
pa'a	pqa	
belhariya	byw	
north arabian	xna	
lumbu	lup	
literary chinese	lzh	
uru-eu-wau-wau	urz	
burui	bry	
elseng	mrf	
futuna	fud	
malinaltepec tlapanec	tcf	
isu (menchum division)	isu	
malila	mgq	
wolani	wod	
ulwa	ulw	sum	
pinjarup	pnj	
degema	deg	
mato grosso arára	axg	
dzodinka	add	
primitive irish	pgl	
jamamadí	jaa	
tesaka malagasy	tkg	
koro (côte d'ivoire)	kfo	
xavánte	xav	
teso	teo	
western magar	mrd	
bhoti	sbu	spt	
borna (ethiopia)	bwo	
fum	fum	
tutchone	tce	ttm	
northern tarahumara	thh	
emae	mmw	
ternateño	tmg	
momuna	mqf	
eravallan	era	
konabéré	bbo	
greek sign language	gss	
awara	awx	
tswa	tsc	
southern nisu	nsd	
anam	pda	
yaleba	ylb	
sìcìté sénoufo	sep	
hadza	hts	
guerrero amuzgo	amu	
salasaca highland quichua	qxl	
kalkutung	ktg	
cotoname	xcn	
tsonga	tso	
canichana	caz	
aiome	aki	
itene	ite	
dogon	aqd	dbg	dbt	dbu	dbw	dds	dgb	djm	dmb	dti	dtk	dtm	dto	dts	dtt	dtu	dym	nzz	tde	
romam	rmx	
nake	nbk	
benga	bng	
yukatek	yua	
lambichhong	lmh	
gbin	xgb	
tobian	tox	
altai	alt	atv	
vaiphei	vap	
wipi	gdr	
talossan	tzl	
sou nama	tlt	
sechelt	sec	
rajah kabunsuwan manobo	mqk	
evant	bzz	
nimbari	nmr	
!kung	vaj	
central huishui miao	hmc	
thurawal	tbh	
china buriat	bxu	
tsum	ttz	
bulo stieng	sti	
kulina	cul	
brokskat	bkk	
luwian	hlu	xlu	
hiw	hiw	
tiranige diga dogon	tde	
yoidik	ydk	
karirí-xocó	kzw	
lunanakha	luk	
mama	mma	
tanaina	tfn	
suba-simbiti	ssc	
bats	bbl
batsbi	bbl
salt-yui	sll	
urat	urt	
legbo	agb	
binji	bpj	
koyaga	kga	
laeko-libuat	lkl	
ambai	amk	
san juan colorado mixtec	mjc	
awar	aya	
ineseño	inz	
judeo-tunisian arabic	ajt	
makhuwa-meetto	mgh	
mota	mtt	
baga sobané	bsv	
mafea	mkv	
totonac	tcw	tku	tlc	tlp	toc	too	top	tos	tqt	
mah meri	mhe	
interglossa	igs	
tagdal	tda	
kiwai	kiw	kjd	
tamnim citak	tml	
atsam	cch	
songomeno	soe	
mannan	mjv	
lenkau	ler	
ludian	lud	
juquila mixe	mxq	
saluan	loe	
jangshung	jna	
mangas	zns	
awyi	auw	
biage	bdf	
zari	zaz	
kokota	kkk	
kara (papua new guinea)	leu	
norwegian bokmål	nob	
berawan	zbc	zbe	zbw	
ojitlán chinantec	chj	
nigerian fulfulde	fuv	
nyaturu	rim	
early modern english	mis	
viid	snu	
pom	pmo	
pashai	aee	glh	psh	psi	
indus valley language	xiv	
kuruáya	kyr	
yaaku	muu	
gundungurra	xrd	
japanese sign language	jsl	
ayi (papua new guinea)	ayq	
malimpung	mli	
borei	gai	
yana	ynn	
acipa	acp	
kambaata	ktb	
mon	mnw	omx	
tanema	tnx	
njalgulgule	njl	
corsican	cos	
mbalanhu	lnb	
gusan	gsn	
ottawa	otw	
samoan	smo	
man met	mml	
aringa	luc	
plapo krumen	ktj	
nara	nrb	
cochimi	coj	
kuy	kdt	
nyigina	nyh	
ura (vanuatu)	uur	
danu	dnv	
motlav	mlv	
mpumpong	mgg	
fijian	fij	wyy	
negeri sembilan malay	zmi	
austrian sign language	asq	
remun	lkj	
anuta	aud	
west tarangan	txn	
mayi-yapi	xyj	
shambala	ksb	
zaysete	zay	
mono (democratic republic of congo)	mnh	
bisis	bnw	
pará arára	aap	
guduf-gava	gdf	
nukumanu	nuq	
turiwára	twt	
kagulu	kki	
brunei	kxd	
uruangnirin	urn	
kerak	hhr	
phuong	phg	
zulu	zul	
chukchee	ckt	
dime	dim	
tenino	tqn	
halia	hla	
ali	aiy	
matsés	mcf	
lamboya	lmy	
khams tibetan	khg	
south tairora	omw	
xerénte	xer	
muzi	ymz	
karey	kyd	
ncane	ncr	
sebat bet gurage	sgw	
chiru	cdf	
abai sungai	abf	
michif	crg	
parsi	prp	
suoy	syo	
ede cabe	cbj	
dirari	dit	
even	eve	
sri lankan sign language	sqs	
ogbia	ogb	
ikpeng	txi	
nyakyusa-ngonde	nyy	
nuu-chah-nulth	nuk	
liberia kpelle	xpe	
soyaltepec mixtec	vmq	
kelon	kyo	
nding	eli	
harijan kinnauri	kjo	
wandarang	wnd	
uru-pa-in	urp	
gilbertese	gil	
epie	epi	
ngindo	nnq	
bilbil	brz	
gikyode	acd	
chitkuli kinnauri	cik	
gamo-ningi	bte	
uru	ure	
tangchangya	tnv	
rennell-bellona	mnv	
áncá	acb	
äiwoo	nfl	
tai laing	tjl	
llengua de signes catalana	csc	
bukiyip	ape	
tii	txq	
mombum	mso	
north mesopotamian arabic	ayp	
naga pidgin	nag	
brokpake	sgt	
khvarshi	khv	
south ucayali ashéninka	cpy	
kosare	kiq	
kaimbé	xai	
slovene	slv	
aralle-tabulahan	atq	
sindihui mixtec	xts	
daai chin	dao	
angkamuthi	avm	
jinyu chinese	cjy	
nisu	nos	nsd	nsf	nsv	yiv	
tsou	tsu	
arta	atz	
sarua	swy	
varisi	vrs	
maung	mph	
bundeli	bns	
chambri	can	
chhattisgarhi	hne	
iyayu	iya	
ampari dogon	aqd	
north picene	nrp	
swiss-french sign language	ssr	
bunun	bnn	
koyraboro senni songhay	ses	
coyutla totonac	toc	
southern uzbek	uzs	
xinca	xin	
bankon	abb	
weliki	klh	
lewotobi	lwt	
kon keu	kkn	
kango (bas-uélé district)	kty	
kaimbulawa	zka	
kagoma	kdm	
abure	abu	
muji	ymc	ymq	ymx	
yahadian	ner	
baluan-pam	blq	
nganasan	nio	
butuanon	btw	
baka (cameroon)	bkc	
wolio	wlo	
georgian	kat	oge	
djamindjung	djd	
gayil	gyl	
odia	ory	
ili turki	ili	
koropó	xxr	
bengkala sign language	bqy	
galice	gce	
classical mongolian	cmg	
ebrié	ebr	
traveller scottish	trl	
serudung murut	srk	
quioquitani-quierí zapotec	ztq	
maram naga	nma	
parenga	pcj	
dyan	dya	
berakou	bxv	
tajik	tgk	
nyeu	nyl	
nugunu (cameroon)	yas	
sause	sao	
hmong	hma	hmc	hme	hmg	hmh	hmi	hml	hmm	hmn	hmp	hmw	hmy	huj	blu	
muluridyi	vmu	
min dong chinese	cdo	
wancho naga	nnp	
wamey	cou	
ngarinyin	ung	
asumboa	aua	
ternate	tft	
busam	bxs	
gugubera	kkp	
ache	yif	
yansi	yns	
wojenaka	jod	
lomaiviti	lmv	
western mari	mrj	
nda'nda'	nnz	
uradhi	urf	
ir	irr	
eastern muria	emu	
portuguese sign language	psr	
baki	bki	
mysian	yms	
dhudhuroa	ddr	
pambia	pmb	
takuu	nho	
serbo-croatian	hbs	srp	
northern alta	aqn	
hema	nix	
buru (nigeria)	bqw	
kosli	spv	
mandjak	mfv	
pijao	pij	
mono (cameroon)	mru	
xukurú	xoo	
fanbak	fnb	
zoroastrian dari	gbz	
katabaga	ktq	
kaningra	knr	
chagatai	chg	
dilling	dil	
tifal	tif	
mogofin	mfg	
thopho	ytp	
ngaanyatjarra	ntj	
garingbal	xgi	
sharwa	swq	
ancient zapotec	xzp	
buhutu	bxh	
moma	myl	
tsoa	hio	
piro	pie	
to'aba'ita	mlu	
kiunum	wei	
gunya	gyy	
manichaean middle persian	xmn	
sarli	sdf	
zacatlán-ahuacatlán-tepetzintla nahuatl	nhi	
western tlacolula valley zapotec	zab	
zemba	dhm	
budibud	btp	
early tripuri	xtr	
eastern egyptian bedawi arabic	avl	
turkmen	tuk	
kol (cameroon)	biw	
sepa (indonesia)	spb	
inuit sign language	iks	
t'en	tct	
matu chin	hlt	
kamar	keq	
eitiep	eit	
sepik iwam	iws	
zumbun	jmb	
finnish sign language	fse	
drubea	duf	
slave (athapascan)	den	
bomboli	bml	
gourmanchéma	gux	
tima	tms	
bohtan neo-aramaic	bhn	
chorasmian	xco	
maiwa (papua new guinea)	mti	
bonkeng	bvg	
tanguat	tbs	
mape	mlh	
nyishi	njz	
chinook jargon	chn	
nen	nqn	
fungwa	ula	
mwan	moa	
mixe	mco	mir	mto	mxp	mxq	mzl	neq	pxm	
tringgus-sembaan bidayuh	trx	
nisa	njs	
shixing	sxg	
west kewa	kew	
biyo	byo	
western keres	kjq	
kokoda	xod	
nicaragua creole english	bzk	
massep	mvs	
ono	ons	
kanowit-tanjong melanau	kxn	
tagabawa	bgs	
kereho	xke	
faliscan	xfa	
wageman	waq	
ulster	gle	
belait	beg	
creole english	aig	bah	bzk	fpe	gcl	gul	gyn	hwc	icr	jam	svc	tch	tgh	trf	vic	
serbian	srp	
swahili (macrolanguage)	swa	
lepki	lpe	
orya	ury	
kurudu	kjr	
aurá	aux	
kxoe	xuu	
aekyom	awi	
yawa	yva	
southern mashan miao	hma	
tawoyan	twy	
korean	kor	okm	oko	
saterfriesisch	stq	
jogi	jog	
uri	uvh	
la'bi	lbi	
ejagham	etu	
krache	kye	
bellari	brw	
korop	krp	
koroni	xkq	
aroplokep	apr	
nalu	naj	
laura	lur	
buginese	bug	
macaguán	mbn	
aiklep	mwg	
ndom	nqm	
segai	sge	
mawa (nigeria)	wma	
burunge	bds	
tefaro	tfo	
sirionó	srq	
omi	omi	
tejalapan zapotec	ztt	
khandesi	khn	
lengilu	lgi	
prussian	prg	
yucatec maya sign language	msd	
eteocretan	ecr	
kimaama	kig	
ogbah	ogc	
kowiai	kwh	
wala	lgl	
southern balochi	bcc	
luopohe miao	hml	
mumuye	mzm	
gula (central african republic)	kcm	
okpe (southwestern edo)	oke	
arguni	agf	
burduna	bxn	
kurama	krh	
kera	ker	
bissa	bib	
geji	gji	
guahibo	guh	
lamja-dengsa-tola	ldh	
wannu	jub	
central pame	pbs	
enggano	eno	
bafaw-balong	bwt	
shangzhai	jih	
leinong naga	lzn	
nage	nxe	
tunen	tvu	
nupe-nupe-tako	nup	
thayore	thd	
lower burdekin	xbb	
korean sign language	kvk	
pashto	pbt	pbu	pst	pus	
votic	vot	
milyan	imy	
dengka	dnk	
nyika (tanzania)	nkt	
west central oromo	gaz	
asuriní	asn	
mukulu	moz	
buna	bvn	
anakalangu	akg	
holoholo	hoo	
divehi	div	
fula	fuv	
inuinnaqtun	ikt	
warao	wba	
eastern meohang	emg	
reshe	res	
elamite	elx	
thu lao	tyl	
belize kriol english	bzj	
northwest maidu	mjd	
ngul	nlo	
kwomtari	kwo	
lutachoni	lts	
guanyinqiao	jiq	
boko (democratic republic of congo)	bkp	
ito	itw	
punic	xpu	
acatepec me'phaa	tpx	
marachi	lri	
bhili	bhb	
rongmei naga	nbu	
sula	szn	
cuyonon	cyo	
boikin	bzf	
nauo	nwo	
asmat	asc	asy	cns	nks	
rural palestine arabic	ajp	
late middle chinese	ltc	
nambya	nmq	
panim	pnr	
oko-juwoi	okj	
tondano	tdn	
kunggari	kgl	
north giziga	gis	
efik	efi	
waka	wav	
hangaza	han	
middle irish (900-1200)	mga	
mian	mpt	
muna	mnb	
nicobarese	caq	ncb	nik	
etkywan	ich	
lamu	llh	
koshin	kid	
dirasha	gdl	
kaurna	zku	
otoro	otr	
lamalera	lmr	
tagakaulo	klg	
temiar	tea	
gata'	gaq	
el nayar cora	crn	
lehali	tql	
balkan gagauz turkish	bgx	
dadibi	mps	
heyo	auk	
lola	lcd	
maleu-kilenge	mgl	
puyo-paekche	xpp	
northern guiyang hmong	huj	
goemai	ank	
kilivila	kij	
gurani	hac	
kharam naga	kfw	
papuma	ppm	
alekano	gah	
wichí lhamtés nocten	mtp	
argobba	agj	
maeng itneg	itt	
shehri	shv	
dek	dek	
namo	mxw	
western niger fulfulde	fuh	
awa-cuaiquer	kwi	
mbere	mdt	
bolivian sign language	bvl	
awa (china)	vwa	
tsimané	cas	
ladakhi	lbj	
kuvi	kxv	
tongwe	tny	
mündü	muh	
niuean	niu	
mapun	sjm	
korku	kfq	
kiput	kyi	
uruava	urv	
piti	pcn	
malimba	mzd	
sea island creole english	gul	
sio	xsi	
tatar	crh	sty	tat	
mbangala	mxg	
siawi	mmp	
ngandi	nid	
togbo-vara banda	tor	
ngad'a	nea	nxg	
western maninkakan	mlq	
mbunda	mck	
kom (cameroon)	bkm	
norwegian nynorsk	nno	
yalakalore	xyl	
gejia	hmj	
northern mashan miao	hmp	
khakas	kjh	
soninke	snk	
wagawaga	wgb	
ngala	nud	
west lembata	lmj	
hemba	hem	
puno quechua	qxp	
anfillo	myo	
bongili	bui	
ingush	inh	
gichuka	cuh	
oti	oti	
lamenu	lmu	
central asmat	cns	
guntai	gnt	
mlahsö	lhs	
korana	kqz	
torwali	trw	
kobol	kgu	
armenian	axm	hye	xcl	
arutani	atx	
watut	mcy	mpl	una	
guttannen	gsw	
moere	mvq	
coast miwok	csi	
enlhet	enl	
yoba	yob	
ayu	ayu	
jhankot sign language	jhs	
miriti	mmv	
koibal	zkb	
sialum	slw	
selkup	sel	
guguyimidjir	kky	
stodsde	jih	
central bikol	bcl	
kharia thar	ksy	
west berawan	zbw	
mün chin	mwq	
mubi	mub	
zaniza zapotec	zpw	
nii	nii	
ngwo	ngn	
vitu	wiv	
lumba-yakkha	luu	
pima	ood	
kurumba	kfi	kpb	pkr	xua	xub	xuj	
hiri motu	hmo	
mari (russia)	chm	
kuwaa	blh	
ndombe	ndq	
rongpo	rnp	
wè western	wec	
american sign language	ase	
lezgian	lez	
darlong	dln	
maria (india)	mrr	
itneg	bjx	itb	iti	itt	ity	tis	
wotapuri-katarqalai	wsv	
ninia yali	nlk	
rembarunga	rmb	
north levantine arabic	apc	
atzingo matlatzinca	ocu	
cubeo	cub	
kentish sign language	okl	
vasekele	vaj	
sisaala	sil	ssl	
wirangu	wgu	
maay	ymm	
ntomba	nto	
sonia	siq	
dieri	dif	
liujiang zhuang	zlj	
tai dón	twh	
seti	sbi	
samogitian	sgs	
seke (vanuatu)	ske	
lonzo	lnz	
kokata	ktd	
dani	dna	dni	dnt	dnw	
moksha	mdf	
lachixío zapotec	zpl	
old aramaic (up to 700 bce)	oar	
bahing	bhj	
mediak	mwx	
wilawila	wil	
khasi	kha	
burumakok	aip	
bilma kanuri	bms	
keiyo	eyo	
luyana	lyn	
halbi	hlb	
bila	bip	
touo	tqu	
poqomam	poc	
bijori	bix	
ixcatec	ixc	
eshtehardi	esh	
kundal shahi	shd	
kayaw	kvl	
ngombe (central african republic)	nmj	
tenggarong kutai malay	vkt	
sensi	sni	
yir yoront	yyr	
gowro	gwf	
jorto	jrt	
khuen	khf	
australian sign language	asf	
achuar-shiwiar	acu	
mekwei	msf	
bomu	bmq	
ikalanga	kck	
sunum	ymn	
chaha	sgw	
sha	scw	
pamosu	hih	
yorta yorta	xyy	
inuit	kal	ike	
kopar	xop	
tumtum	tbr	
anor	anj	
coatepec nahuatl	naz	
southern hindko	hnd	
obo manobo	obo	
nakame	nib	
idesa	ids	
southwestern huishui miao	hmh	
kuku-yalanji	gvn	
highland konjo	kjk	
bisa	bib	
cibak	ckl	
western tamang	tdg	
ami	amy	
soyaltepec mazatec	vmp	
turkic khalaj	klj	
torau	ttu	
peranakan	pea	
limilngan	lmc	
ghomálá'	bbj	
kaivi	kce	
balinese	ban	
laalaa	cae	
komi-permyak	koi	
ai-cham	aih	
ibu	ibu	
baras	brs	
wogamusin	wog	
ronga	rng	
nusa laut	nul	
soga	xog	
fipa	fip	
nakai	nkj	
shumcho	scu	
camtho	cmt	
klamath-modoc	kla	
demta	dmy	
kaptiau	kbi	
kélé	keb	
fala	fax	
phuan	phu	
kumarbhag paharia	kmj	
otuke	otu	
bada (indonesia)	bhz	
maleng	pkt	
ere	twp	
kung	kfl	
masai	mas	
nicarao	ppl	
timbisha	par	
clallam	clm	
mmen	bfm	
helong	heg	
dadi dadi	dda	
bambara	bam	
sabüm	sbo	
nakwi	nax	
ngäbere	gym	
baharna arabic	abv	
cayuse	xcy	
sacapulteco	quv	
sranan tongo	srn	
nar phu	npa	
amri karbi	ajz	
n/u	ngh	
bangandu	bgf	
matlatzinca	mat	ocu	
tapieté	tpj	
mandarin chinese	cmn	
arbëreshë albanian	aae	
southern nuni	nnw	
sekar	skz	
ede ije	ijj	
bibbulman	xbp	
kedang	ksx	
banjar	bjn	
logooli	rag	
numana-nunku-gbantu-numbu	nbr	
abar	mij	
aloápam zapotec	zaq	
pwapwâ	pop	
miriwung	mep	
judeo-yemeni arabic	jye	
central subanen	syb	
kalamsé	knz	
spokane	spo	
upper kuskokwim	kuu	
tiri	cir	
saaroa	sxr	
iraqw	irk	
langbashe	lna	
rotokas	roo	
kirmanjki (individual language)	kiu	
pudtol atta	atp	
dumagat	agv	
wangkayutyuru	wky	
yeretuar	gop	
leti (cameroon)	leo	
western balochi	bgn	
lele (guinea)	llc	
tsamai	tsb	
koiali	kpx	
eastern pwo	kjp	
usarufa	usa	
miltu	mlj	
shughni	sgh	
larike-wakasihu	alo	
krikati-timbira	xri	
papi	ppe	
sara kaba náà	kwv	
tawara	twl	
teressa	tef	
bieria	brj	
kumiai	dih	
lungalunga	vmg	
pilagá	plg	
lemoro	ldj	
dabarre	dbr	
musak	mmq	
aguna	aug	
loke	loy	
lilau	lll	
yaka (central african republic)	axk	
wetamut	wwo	
kaili	kzf	lew	unz	
mbariman-gudhinma	zmv	
mam	mam	
mori atas	mzq	
yao samsao	ium	
lenca	len	
chewong	cwg	
bermeo occidental	eus	
eastern xwla gbe	gbx	
chadian sign language	cds	
machinere	mpd	
kutchi	kfr	
songlai chin	csj	
ngile	jle	
lemio	lei	
/xam	xam	
southern nicobarese	nik	
wadjabangayi	wdy	
coptic	cop	
yagnobi	yai	
kalam	kmh	
abu	ado	
weme gbe	wem	
sartang	onp	
önge	oon	
eastern oromo	hae	
oluwanga	lwg	
seneca	see	
pear	pcb	
central bai	bca	
xârâcùù	ane	
gergiko	moz	
kabwari	kcw	
ritarungo	rit	
northern hindko	hno	
gbaya-mbodomo	gmm	
sera	sry	
laghuu	lgh	
kitharaka	thk	
chimila	cbg	
afar	aar	
ho chi minh city sign language	hos	
tanjijili	uji	
yali	nlk	yac	yli	
mixtepec mixtec	mix	
nipsan	nps	
chuvash	chv	
igwe	igw	
western neo-aramaic	amw	
